originals	tokenized	transliterated
kărāhā	k ă r ā h ā	k ᾰ r aː h aː
koedŏdŏkŏ	k oe d ŏ d ŏ k ŏ	k u d ɔ d ɔ k ɔ
èoeloe	è oe l oe	ɛ u l u
èoedoe	è oe d oe	ɛ u d u
èbaka	è b a k a	ɛ b a k a
èkoe(k)	è k oe (k)	ɛ k u ʔ
èaoeloe	è a oe l oe	ɛ a u l u
poeroeroe èoeloe	p oe r oe r oe + è oe l oe	p u r u r u + ɛ u l u
kèlĕkèlĕ poeĕkā	k è l ĕ k è l ĕ + p oe ĕ k ā	k ɛ l ə k ɛ l ə + p u ə k aː
kariehā	k a r ie h ā	k a r i ç aː
kaliehĕ	k a l ie h ĕ	k a l i ç ə
èbaka	è b a k a	ɛ b a k a
koepènobaka	k oe p è n o b a k a	k u p ɛ n ɔ b a k a
bèbaka	b è b a k a	b ɛ b a k a
èfanoe	è f a n oe	ɛ f a n u
èpanoe	è p a n oe	ɛ p a n u
èfāfā	è f ā f ā	ɛ f aː f aː
èkāā	è k āā	ɛ k aː
koelīfŏ	k oe l ī f ŏ	k u l iː f ɔ
pārŏrīpŏ	p ā r ŏ r ī p ŏ	p aː r ɔ r iː p ɔ
parŏrīpŏ	p a r ŏ r ī p ŏ	p a r ɔ r iː p ɔ
èki(k)	è k i (k)	ɛ k i ʔ
fārŏrīfŏ	f ā r ŏ r ī f ŏ	f aː r ɔ r iː f ɔ
èlieŏ	è l ie ŏ	ɛ l i ɔ
èdieŏ	è d ie ŏ	ɛ d i ɔ
kinoe-oeka	k i n oe - oe k a	k i n u - u k a
nienie	n ie n ie	n i n i
nienie	n ie n ie	n i n i
kĕmoekā(k)	k ĕ m oe k ā (k)	k ə m u k aː ʔ
kīnoeoekă	k ī n oe oe k ă	k iː n u u k ᾰ
ehanoe(k)	e h a n oe (k)	e h a n u ʔ
èokahaĕ	è o k a h a ĕ	ɛ ɔ k a h a ə
èămah	è ă m a h	ɛ ᾰ m a h
èkŏkŏ(k)	è k ŏ k ŏ (k)	ɛ k ɔ k ɔ ʔ
èkŏkŏ(k)	è k ŏ k ŏ (k)	ɛ k ɔ k ɔ ʔ
bèkŏkŏ(k)	b è k ŏ k ŏ (k)	b ɛ k ɔ k ɔ ʔ
bèkŏkŏ(k)	b è k ŏ k ŏ (k)	b ɛ k ɔ k ɔ ʔ
pākŏkŏ(k)	p ā k ŏ k ŏ (k)	p aː k ɔ k ɔ ʔ
kaporiĕ	k a p o r i ĕ	k a p ɔ r i ə
eà oekoe	e à + oe k oe	e a + u k u
bŏbŏ	b ŏ b ŏ	b ɔ b ɔ
èbākoe	è b ā k oe	ɛ b aː k u
fèkoe(k)	f è k oe (k)	f ɛ k u ʔ
pèkoe(k)	p è k oe (k)	p ɛ k u ʔ
èkiedai	è k ie d a i	ɛ k i d a i
kèma	k è m a	k ɛ m a
èfoekĕ	è f oe k ĕ	ɛ f u k ə
èfoekĕ	è f oe k ĕ	ɛ f u k ə
èkahāe	è k a h ā e	ɛ k a h aː e
hahapaoe	h a h a p a oe	h a h a p a u
kèkĕ	k è k ĕ	k ɛ k ə
èhokai	è h o k a i	ɛ h ɔ k a i
èhokai	è h o k a i	ɛ h ɔ k a i
poeri(k)	p oe r i (k)	p u r i ʔ
jo(k)	j o (k)	j ɔ ʔ
amaika	a m a i k a	a m a i k a
apiok	a p i o k	a p i ɔ k
èhaie	è h a ie	ɛ h a i
amaika	a m a i k a	a m a i k a
apiok	a p i o k	a p i ɔ k
èhaie	è h a ie	ɛ h a i
èoekoe(k)	è oe k oe (k)	ɛ u k u ʔ
hèla poewe	h è l a + p oe w e	h ɛ l a + p u w e
hèla poewe	h è l a + p oe w e	h ɛ l a + p u w e
eè	e è	e ɛ
hamaiko	h a m a i k o	h a m a i k ɔ
kamaiko	k a m a i k o	k a m a i k ɔ
wamaiko	w a m a i k o	w a m a i k ɔ
è(i)ko	è ( i ) k o	ɛ ( i ) k ɔ
abakiŏbè	a b a k i ŏ b è	a b a k i ɔ b ɛ
hamaiko	h a m a i k o	h a m a i k ɔ
kamaiko	k a m a i k o	k a m a i k ɔ
wamaiko	w a m a i k o	w a m a i k ɔ
è(i)ko	è ( i ) k o	ɛ ( i ) k ɔ
abakiŏbè	a b a k i ŏ b è	a b a k i ɔ b ɛ
ija(k)è	i j a (k) è	i j a ʔ ɛ
ija(k)è	i j a (k) è	i j a ʔ ɛ
hèŏwaj	h è ŏ w a j	h ɛ ɔ w a j
kariha wae	k a r i h a + w a e	k a r i ç a + w a e
èijŏ	è i j ŏ	ɛ i j ɔ
èăpara	è ă p a r a	ɛ ᾰ p a r a
èpoe	è p oe	ɛ p u
fiŏ-fiŏ	f i ŏ - f i ŏ	f i ɔ - f i ɔ
pārāhāoedie	p ā r ā h ā oe d ie	p aː r aː h aː u d i
èafŏ	è a f ŏ	ɛ a f ɔ
alŏfāa	a l ŏ f āa	a l ɔ f aː
èfoe(k) oeafĕ	è f oe (k) + oe a f ĕ	ɛ f u ʔ + u a f ə
hèoafĕ	h è o a f ĕ	h ɛ ɔ a f ə
minoe apŏ	m i n oe + a p ŏ	m i n u + a p ɔ
kau-apŏ	k a u - a p ŏ	k a u - a p ɔ
kaunoeoenoe	k a u n oe oe n oe	k a u n u u n u
naè apo	n a è + a p o	n a ɛ + a p ɔ
naèapo nokie	n a è a p o + n o k ie	n a ɛ a p ɔ + n ɔ k i
èā	è ā	ɛ aː
kijakki	k i j a k k i	k i j a k k i
èhèla	è h è l a	ɛ h ɛ l a
èŏkŏ	è ŏ k ŏ	ɛ ɔ k ɔ
ĕoelie	ĕ oe l ie	ə u l i
foeroeroe	f oe r oe r oe	f u r u r u
èoemo(k)	è oe m o (k)	ɛ u m ɔ ʔ
èitŏfĕ	è i t ŏ f ĕ	ɛ i t ɔ f ə
ahŏpŏ(k)	a h ŏ p ŏ (k)	a h ɔ p ɔ ʔ
amĕnŏ(k)	a m ĕ n ŏ (k)	a m ə n ɔ ʔ
kŏnjŏk	k ŏ nj ŏ k	k ɔ ɲ ɔ k
èabanjŏk	è a b a nj ŏ k	ɛ a b a ɲ ɔ k
iedjo	ie dj o	i d͡ʒ ɔ
kihoeĕ	k i h oe ĕ	k i ç u ə
kŏdŏ(k)	k ŏ d ŏ (k)	k ɔ d ɔ ʔ
oewŏhŏ	oe w ŏ h ŏ	u w ɔ h ɔ
māāniha	m āā n i h a	m aː n i ç a
maènoe	m a è n oe	m a ɛ n u
bakŏkoĕ kafoekakō	b a k ŏ k o ĕ + k a f oe k a k ō	b a k ɔ k ɔ ə + k a f u k a k oː
bahèdie	b a h è d ie	b a h ɛ d i
kifoea	k i f oe a	k i f u a
èèkowĕ	èè k o w ĕ	ɛː k ɔ w ə
bararau	b a r a r a u	b a r a r a u
bakie ŏfŏ	b a k ie + ŏ f ŏ	b a k i + ɔ f ɔ
wakahadŏ	w a k a h a d ŏ	w a k a h a d ɔ
èhekoe	è h e k oe	ɛ h e k u
pakomakja	p a k o m a k j a	p a k ɔ m a k j a
pakowèh	p a k o w è h	p a k ɔ w ɛ h
māākŏ	m āā k ŏ	m aː k ɔ
abaikĕ	a b a i k ĕ	a b a i k ə
kabakīdjŏ	k a b a k ī dj ŏ	k a b a k iː d͡ʒ ɔ
kiparariŏ	k i p a r a r i ŏ	k i p a r a r i ɔ
èdjie	è dj ie	ɛ d͡ʒ i
èfaŏ(k) wa(k)	è f a ŏ (k) + w a (k)	ɛ f a ɔ ʔ + w a ʔ
abaoekakaj	a b a oe k a k a j	a b a u k a k a j
ĕo(k)oi	ĕ o (k) o i	ə ɔ ʔ ɔ i
bèlo	b è l o	b ɛ l ɔ
èo(k)oi	è o (k) o i	ɛ ɔ ʔ ɔ i
kipŏdŏ	k i p ŏ d ŏ	k i p ɔ d ɔ
ahītŏ(k)	a h ī t ŏ (k)	a h iː t ɔ ʔ
èāfākoe	è ā f ā k oe	ɛ aː f aː k u
èèhè	èè h è	ɛː h ɛ
èfāwāfŏ	è f ā w ā f ŏ	ɛ f aː w aː f ɔ
kaoewa(k)	k a oe w a (k)	k a u w a ʔ
kŏŏda	k ŏŏ d a	k ɔː d a
hŏpanènèĕ	h ŏ p a n è n è ĕ	h ɔ p a n ɛ n ɛ ə
kaaĕ	k aa ĕ	k aː ə
baaĕ	b aa ĕ	b aː ə
kabakè	k a b a k è	k a b a k ɛ
èamaha	è a m a h a	ɛ a m a h a
patăhālè	p a t ă h ā l è	p a t ᾰ h aː l ɛ
ĕèma	ĕ è m a	ə ɛ m a
èa kanapoeĕ	è a + k a n a p oe ĕ	ɛ a + k a n a p u ə
èa kanapoeĕ	è a + k a n a p oe ĕ	ɛ a + k a n a p u ə
èa kanapoeĕ	è a + k a n a p oe ĕ	ɛ a + k a n a p u ə
kadihoekā	k a d i h oe k ā	k a d i ç u k aː
iabahoekā	i a b a h oe k ā	i a b a h u k aː
kīīdōka	k īī d ō k a	k iː d oː k a
èoedafak	è oe d a f a k	ɛ u d a f a k
djako	dj a k o	d͡ʒ a k ɔ
kafoehĕ	k a f oe h ĕ	k a f u h ə
kapoehŏ	k a p oe h ŏ	k a p u h ɔ
kafoehĕ	k a f oe h ĕ	k a f u h ə
kafoehĕ	k a f oe h ĕ	k a f u h ə
kāoewŏ	k ā oe w ŏ	k aː u w ɔ
kĕlèpè	k ĕ l è p è	k ə l ɛ p ɛ
èadoh	è a d o h	ɛ a d ɔ h
kapoehŏ kidai	k a p oe h ŏ + k i d a i	k a p u h ɔ + k i d a i
ĕjoe	ĕ j oe	ə j u
nanaoeni	n a n a oe n i	n a n a u n i
nanaoeni	n a n a oe n i	n a n a u n i
pakoenoejĕ	p a k oe n oe j ĕ	p a k u n u j ə
èoefoe(k)	è oe f oe (k)	ɛ u f u ʔ
piŏnā	p i ŏ n ā	p i ɔ n aː
èla akowĕ	è l a + a k o w ĕ	ɛ l a + a k ɔ w ə
kapoehŏ èoeloe	k a p oe h ŏ + è oe l oe	k a p u h ɔ + ɛ u l u
kapoehŏ èa	k a p oe h ŏ + è a	k a p u h ɔ + ɛ a
ènèĕ	è n è ĕ	ɛ n ɛ ə
ĕkihŏ	ĕ k i h ŏ	ə k i ç ɔ
kifafakoe(k)	k i f a f a k oe (k)	k i f a f a k u ʔ
kamakoewa	k a m a k oe w a	k a m a k u w a
kiŏnŏk	k i ŏ n ŏ k	k i ɔ n ɔ k
kehèko(k)ĕ	k e h è k o (k) ĕ	k e h ɛ k ɔ ʔ ə
kiho(k)ja	k i h o (k) j a	k i ç ɔ ʔ j a
kifarai	k i f a r a i	k i f a r a i
kifalai èbeo	k i f a l a i + è b e o	k i f a l a i + ɛ b e ɔ
kifèhŏdŏ	k i f è h ŏ d ŏ	k i f ɛ h ɔ d ɔ
kakèbara	k a k è b a r a	k a k ɛ b a r a
kakènèbaka	k a k è n è b a k a	k a k ɛ n ɛ b a k a
kipakahariebaka	k i p a k a h a r ie b a k a	k i p a k a h a r i b a k a
kipakahariebaka	k i p a k a h a r ie b a k a	k i p a k a h a r i b a k a
hŏbaoeĕ	h ŏ b a oe ĕ	h ɔ b a u ə
hokŏrŏŏ	h o k ŏ r ŏŏ	h ɔ k ɔ r ɔː
habèlĕk	h a b è l ĕ k	h a b ɛ l ə k
koahaijĕ	k o a h a i j ĕ	k ɔ a h a i j ə
èhāhā(k)	è h ā h ā (k)	ɛ h aː h aː ʔ
èhāhā(k)	è h ā h ā (k)	ɛ h aː h aː ʔ
èhāhā(k)	è h ā h ā (k)	ɛ h aː h aː ʔ
nioennā tīō	n i oe nn ā + t ī ō	n i u nː aː + t iː oː
kapapo ĕ	k a p a p o + ĕ	k a p a p ɔ + ə
èmanī	è m a n ī	ɛ m a n iː
èhōda	è h ō d a	ɛ h oː d a
èmanī	è m a n ī	ɛ m a n iː
èhōda	è h ō d a	ɛ h oː d a
foinana(k)	f o i n a n a (k)	f ɔ i n a n a ʔ
po(k)inamok	p o (k) i n a m o k	p ɔ ʔ i n a m ɔ k
ehaw	e h a w	e h a w
pananamie	p a n a n a m ie	p a n a n a m i
nŏwèk	n ŏ w è k	n ɔ w ɛ k
amiemie	a m ie m ie	a m i m i
ama	a m a	a m a
amana	a m a n a	a m a n a
amana	a m a n a	a m a n a
naè	n a è	n a ɛ
naèna	n a è n a	n a ɛ n a
naèna	n a è n a	n a ɛ n a
èara	è a r a	ɛ a r a
èara manie	è a r a + m a n ie	ɛ a r a + m a n i
èara hōda	è a r a + h ō d a	ɛ a r a + h oː d a
oefoenai	oe f oe n a i	u f u n a i
na(k) poenana	n a (k) + p oe n a n a	n a ʔ + p u n a n a
na(k) poewanahalè	n a (k) + p oe w a n a h a l è	n a ʔ + p u w a n a h a l ɛ
āāoe(k)	āā oe (k)	aː u ʔ
āāoe(k)	āā oe (k)	aː u ʔ
èāāk	è āā k	ɛ aː k
èhai(k)	è h a i (k)	ɛ h a i ʔ
na afoeaa(k)	n a + a f oe aa (k)	n a + a f u aː ʔ
kahaoewĕ	k a h a oe w ĕ	k a h a u w ə
kahaoewĕ	k a h a oe w ĕ	k a h a u w ə
èlahŏ	è l a h ŏ	ɛ l a h ɔ
èara kahaoewĕ	è a r a + k a h a oe w ĕ	ɛ a r a + k a h a u w ə
èdadoe èara	è d a d oe + è a r a	ɛ d a d u + ɛ a r a
lahiboekĕ èara	l a h i b oe k ĕ + è a r a	l a h i b u k ə + ɛ a r a
oewakipăkoekă	oe w a k i p ă k oe k ă	u w a k i p ᾰ k u k ᾰ
dipăkoekă	d i p ă k oe k ă	d i p ᾰ k u k ᾰ
anŏ(k)	a n ŏ (k)	a n ɔ ʔ
kèābāoewā āno(k)	k è ā b ā oe w ā + ā n o (k)	k ɛ aː b aː u w aː + aː n ɔ ʔ
dadoe(k)	d a d oe (k)	d a d u ʔ
èanŏ(k)	è a n ŏ (k)	ɛ a n ɔ ʔ
lahè boewă(k)	l a h è + b oe w ă (k)	l a h ɛ + b u w ᾰ ʔ
èloffo	è l o ff o	ɛ l ɔ fː ɔ
kaoedara	k a oe d a r a	k a u d a r a
kowèk	k o w è k	k ɔ w ɛ k
hantoe	h a n t oe	h a n t u
èkowèk kaoeè	è k o w è k + k a oe è	ɛ k ɔ w ɛ k + k a u ɛ
hantoe	h a n t oe	h a n t u
èkowèk kiŏha	è k o w è k + k i ŏ h a	ɛ k ɔ w ɛ k + k i ɔ h a
ĕhĕla	ĕ h ĕ l a	ə h ə l a
baridaha	b a r i d a h a	b a r i d a h a
pānānahoe	p ā n ā n a h oe	p aː n aː n a h u
pānānahoe	p ā n ā n a h oe	p aː n aː n a h u
pānānahoe	p ā n ā n a h oe	p aː n aː n a h u
èdjiekanafoeĕ bŏdŏ	è dj ie k a n a f oe ĕ + b ŏ d ŏ	ɛ d͡ʒ i k a n a f u ə + b ɔ d ɔ
èhèboe	è h è b oe	ɛ h ɛ b u
èhèboe	è h è b oe	ɛ h ɛ b u
kodāpākāhā	k o d ā p ā k ā h ā	k ɔ d aː p aː k aː h aː
kèkiĕ abŏdō	k è k i ĕ + a b ŏ d ō	k ɛ k i ə + a b ɔ d oː
kodanŏŏ	k o d a n ŏŏ	k ɔ d a n ɔː
kaoewa	k a oe w a	k a u w a
kiŏhā	k i ŏ h ā	k i ɔ h aː
hiārā nŏā	h i ā r ā + n ŏ ā	h i aː r aː + n ɔ aː
èahawĕ	è a h a w ĕ	ɛ a h a w ə
èoebatowè	è oe b a t o w è	ɛ u b a t ɔ w ɛ
èjahakaoewĕ	è j a h a k a oe w ĕ	ɛ j a h a k a u w ə
radja	r a dj a	r a d͡ʒ a
mantri	m a n t r i	m a n t r i
èjahakowèk	è j a h a k o w è k	ɛ j a h a k ɔ w ɛ k
kafoe	k a f oe	k a f u
kipara èbahaoe	k i p a r a + è b a h a oe	k i p a r a + ɛ b a h a u
aoena(k) èbahaoe	a oe n a (k) + è b a h a oe	a u n a ʔ + ɛ b a h a u
pidjaja	p i dj a j a	p i d͡ʒ a j a
kiàkoebai	k i à k oe b a i	k i a k u b a i
kiàkoebai	k i à k oe b a i	k i a k u b a i
èhoukè	è h o u k è	ɛ h ɔ u k ɛ
kidĕhoi	k i d ĕ h o i	k i d ə h ɔ i
paèmŏ	p a è m ŏ	p a ɛ m ɔ
kakau	k a k a u	k a k a u
palahiboewĕ	p a l a h i b oe w ĕ	p a l a h i b u w ə
fakoewĕ	f a k oe w ĕ	f a k u w ə
oekŏ nainĕ	oe k ŏ + n a i n ĕ	u k ɔ + n a i n ə
kiŏmahoe	k i ŏ m a h oe	k i ɔ m a h u
moemahoe	m oe m a h oe	m u m a h u
kŏhaiĕ	k ŏ h a i ĕ	k ɔ h a i ə
paè	p a è	p a ɛ
èhijoe	è h i j oe	ɛ h i j u
pahoemè	p a h oe m è	p a h u m ɛ
kamioe	k a m i oe	k a m i u
èoekoek	è oe k oe k	ɛ u k u k
èobĕ	è o b ĕ	ɛ ɔ b ə
èkŏhŏa(k)	è k ŏ h ŏ a (k)	ɛ k ɔ h ɔ a ʔ
poeroeroedija	p oe r oe r oe d i j a	p u r u r u d i j a
èoekoe	è oe k oe	ɛ u k u
ko(k)èko(k)	k o (k) è k o (k)	k ɔ ʔ ɛ k ɔ ʔ
anèka	a n è k a	a n ɛ k a
èkèo(k)	è k è o (k)	ɛ k ɛ ɔ ʔ
kinŏnŏ	k i n ŏ n ŏ	k i n ɔ n ɔ
èkarobă	è k a r o b ă	ɛ k a r ɔ b ᾰ
èkarobă	è k a r o b ă	ɛ k a r ɔ b ᾰ
èhèja	è h è j a	ɛ h ɛ j a
èhèja	è h è j a	ɛ h ɛ j a
emenaha	e m e n a h a	e m e n a h a
emenaha	e m e n a h a	e m e n a h a
èoekoe(k)	è oe k oe (k)	ɛ u k u ʔ
piefie	p ie f ie	p i f i
èaahai	è aa h a i	ɛ aː h a i
kobarieè	k o b a r ie è	k ɔ b a r i ɛ
koenă(k)	k oe n ă (k)	k u n ᾰ ʔ
pohanoema	p o h a n oe m a	p ɔ h a n u m a
èoewĕhoă	è oe w ĕ h o ă	ɛ u w ə h ɔ ᾰ
klamboe	k l a m b oe	k l a m b u
èoewĕhoă	è oe w ĕ h o ă	ɛ u w ə h ɔ ᾰ
fahoeroe	f a h oe r oe	f a h u r u
lapĕ(k)	l a p ĕ (k)	l a p ə ʔ
tikar	t i k a r	t i k a r
dadŏ èoeloe	d a d ŏ + è oe l oe	d a d ɔ + ɛ u l u
èhŏkŏ èoeloe	è h ŏ k ŏ + è oe l oe	ɛ h ɔ k ɔ + ɛ u l u
èko ĕma	è k o + ĕ m a	ɛ k ɔ + ə m a
èoko ĕ	è o k o + ĕ	ɛ ɔ k ɔ + ə
ĕpo(k)	ĕ p o (k)	ə p ɔ ʔ
èhaĕ	è h a ĕ	ɛ h a ə
èjobie	è j o b ie	ɛ j ɔ b i
eapoeha	e a p oe h a	e a p u h a
èafauje	è a f a u j e	ɛ a f a u j e
pakoehoeĕ	p a k oe h oe ĕ	p a k u h u ə
kahihŏ	k a h i h ŏ	k a h i ç ɔ
kidoeroeka	k i d oe r oe k a	k i d u r u k a
papărie èjobie	p a p ă r ie + è j o b ie	p a p ᾰ r i + ɛ j ɔ b i
kihŏ èjobie	k i h ŏ + è j o b ie	k i ç ɔ + ɛ j ɔ b i
poeroe èjobie	p oe r oe + è j o b ie	p u r u + ɛ j ɔ b i
ŏkŏ	ŏ k ŏ	ɔ k ɔ
èīpo(k)	è ī p o (k)	ɛ iː p ɔ ʔ
èkoewĕ	è k oe w ĕ	ɛ k u w ə
doehoekiĕ(k)	d oe h oe k i ĕ (k)	d u h u k i ə ʔ
janieka	j a n ie k a	j a n i k a
poeroe	p oe r oe	p u r u
ekŏnŏnŏhā	e k ŏ n ŏ n ŏ h ā	e k ɔ n ɔ n ɔ h aː
kidjoearŏjĕ	k i dj oe a r ŏ j ĕ	k i d͡ʒ u a r ɔ j ə
klamboe	k l a m b oe	k l a m b u
èhèkoeĕ	è h è k oe ĕ	ɛ h ɛ k u ə
rarieĕ	r a r ie ĕ	r a r i ə
èfoefoe	è f oe f oe	ɛ f u f u
èpoepoe	è p oe p oe	ɛ p u p u
pahoemè	p a h oe m è	p a h u m ɛ
pahoemè	p a h oe m è	p a h u m ɛ
ōnèkĕ	ō n è k ĕ	oː n ɛ k ə
èkainŏ(k)	è k a i n ŏ (k)	ɛ k a i n ɔ ʔ
mangkŏ(k)	m a ng k ŏ (k)	m a ŋ k ɔ ʔ
tiko	t i k o	t i k ɔ
èau	è a u	ɛ a u
èau	è a u	ɛ a u
èau	è a u	ɛ a u
fèdjie	f è dj ie	f ɛ d͡ʒ i
fèdjie	f è dj ie	f ɛ d͡ʒ i
pakamai	p a k a m a i	p a k a m a i
èkèh	è k è h	ɛ k ɛ h
sendoq	s e n d o q	s e n d ɔ ʔ
sendoq	s e n d o q	s e n d ɔ ʔ
krandjang	k r a n dj a ng	k r a n d͡ʒ a ŋ
krandjang	k r a n dj a ng	k r a n d͡ʒ a ŋ
krandjang	k r a n dj a ng	k r a n d͡ʒ a ŋ
krandjang	k r a n dj a ng	k r a n d͡ʒ a ŋ
krandjang	k r a n dj a ng	k r a n d͡ʒ a ŋ
lampoe	l a m p oe	l a m p u
eajaha(k) jobi	e a j a h a (k) + j o b i	e a j a h a ʔ + j ɔ b i
soemboe	s oe m b oe	s u m b u
mainoe(k)	m a i n oe (k)	m a i n u ʔ
mainoe(k)	m a i n oe (k)	m a i n u ʔ
èoebadiĕ	è oe b a d i ĕ	ɛ u b a d i ə
èoebĕ kain	è oe b ĕ + k a i n	ɛ u b ə + k a i n
foefoe	f oe f oe	f u f u
poeĕda(k)	p oe ĕ d a (k)	p u ə d a ʔ
pahaboehă	p a h a b oe h ă	p a h a b u h ᾰ
gorèng	g o r è ng	g ɔ r ɛ ŋ
pahèkoe	p a h è k oe	p a h ɛ k u
kè	k è	k ɛ
paboehă	p a b oe h ă	p a b u h ᾰ
koenajŏ	k oe n a j ŏ	k u n a j ɔ
èmèhè(k)	è m è h è (k)	ɛ m ɛ h ɛ ʔ
amĕna(k) mèhè(k)	a m ĕ n a (k) + m è h è (k)	a m ə n a ʔ + m ɛ h ɛ ʔ
dŏdŏ mèhè(k)	d ŏ d ŏ + m è h è (k)	d ɔ d ɔ + m ɛ h ɛ ʔ
hèla kibaka	h è l a + k i b a k a	h ɛ l a + k i b a k a
hèla	h è l a	h ɛ l a
eàjo	e à j o	e a j ɔ
èara kihŏ	è a r a + k i h ŏ	ɛ a r a + k i ç ɔ
èpahjoe	è p a h j oe	ɛ p a h j u
èdakŏ	è d a k ŏ	ɛ d a k ɔ
èēja(k)	è ē j a (k)	ɛ eː j a ʔ
bakèkèk	b a k è k è k	b a k ɛ k ɛ k
pakakak	p a k a k a k	p a k a k a k
kadifakoe	k a d i f a k oe	k a d i f a k u
parihoja(k)	p a r i h o j a (k)	p a r i ç ɔ j a ʔ
boeboer	b oe b oe r	b u b u r
kidjie-kidjie	k i dj ie - k i dj ie	k i d͡ʒ i - k i d͡ʒ i
kŏrŏ-kŏrŏ	k ŏ r ŏ - k ŏ r ŏ	k ɔ r ɔ - k ɔ r ɔ
sajoer	s a j oe r	s a j u r
koeŏdŏ	k oe ŏ d ŏ	k u ɔ d ɔ
karāuwā	k a r ā u w ā	k a r aː u w aː
èbājoe	è b ā j oe	ɛ b aː j u
èoefa	è oe f a	ɛ u f a
foeĕhikoe	f oe ĕ h i k oe	f u ə h i k u
kīkī	k ī k ī	k iː k iː
faikiki	f a i k i k i	f a i k i k i
karihā	k a r i h ā	k a r i ç aː
ènŏmŏnŏmŏ	è n ŏ m ŏ n ŏ m ŏ	ɛ n ɔ m ɔ n ɔ m ɔ
èmi(k)ie	è m i (k) ie	ɛ m i ʔ i
èafie	è a f ie	ɛ a f i
kariha oewapŏ	k a r i h a + oe w a p ŏ	k a r i ç a + u w a p ɔ
kariehĕ	k a r ie h ĕ	k a r i ç ə
kalènang	k a l è n a ng	k a l ɛ n a ŋ
èaai	è aa i	ɛ aː i
koeŏdŏ	k oe ŏ d ŏ	k u ɔ d ɔ
kainèk	k a i n è k	k a i n ɛ k
kapīdjoe pīdjoe	k a p ī dj oe + p ī dj oe	k a p iː d͡ʒ u + p iː d͡ʒ u
pakoewok	p a k oe w o k	p a k u w ɔ k
paioeka	p a i oe k a	p a i u k a
pakākāriē(k)	p a k ā k ā r i ē (k)	p a k aː k aː r i eː ʔ
èko(k)ia	è k o (k) i a	ɛ k ɔ ʔ i a
kadīkakālie	k a d ī k a k ā l ie	k a d iː k a k aː l i
èŏkŏ(k)	è ŏ k ŏ (k)	ɛ ɔ k ɔ ʔ
bĕnang	b ĕ n a ng	b ə n a ŋ
ŏpŏ kabŏkĕ	ŏ p ŏ + k a b ŏ k ĕ	ɔ p ɔ + k a b ɔ k ə
èoba kamakŏ	è o b a + k a m a k ŏ	ɛ ɔ b a + k a m a k ɔ
èhiafo	è h i a f o	ɛ h i a f ɔ
koewabŏ	k oe w a b ŏ	k u w a b ɔ
èkaoijŏ	è k a o i j ŏ	ɛ k a ɔ i j ɔ
èbohè	è b o h è	ɛ b ɔ h ɛ
èpiko(k)	è p i k o (k)	ɛ p i k ɔ ʔ
ŏkia èpiko(k)	ŏ k i a + è p i k o (k)	ɔ k i a + ɛ p i k ɔ ʔ
èara èpiko(k)	è a r a + è p i k o (k)	ɛ a r a + ɛ p i k ɔ ʔ
kīāā	k ī āā	k iː aː
bandèra	b a n d è r a	b a n d ɛ r a
pŏŏkie	p ŏŏ k ie	p ɔː k i
pŏŏkie	p ŏŏ k ie	p ɔː k i
pŏŏkie	p ŏŏ k ie	p ɔː k i
èara fŏŏkie	è a r a + f ŏŏ k ie	ɛ a r a + f ɔː k i
afŏŏkie	a f ŏŏ k ie	a f ɔː k i
pabŏrīkī	p a b ŏ r ī k ī	p a b ɔ r iː k iː
fabŏrīkī	f a b ŏ r ī k ī	f a b ɔ r iː k iː
pafoeroe	p a f oe r oe	p a f u r u
wakoeabŏ	w a k oe a b ŏ	w a k u a b ɔ
kapaleàbŏ	k a p a l e à b ŏ	k a p a l e a b ɔ
pŏŏkie	p ŏŏ k ie	p ɔː k i
kekŏrŏ ĕ	k e k ŏ r ŏ + ĕ	k e k ɔ r ɔ + ə
pakèlie	p a k è l ie	p a k ɛ l i
anĕma	a n ĕ m a	a n ə m a
oewa bakŏhāda	oe w a + b a k ŏ h ā d a	u w a + b a k ɔ h aː d a
hamba soeroeh orang	h a m b a + s oe r oe h + o r a ng	h a m b a + s u r u h + ɔ r a ŋ
kīdāhăk	k ī d ā h ă k	k iː d aː h ᾰ k
eŏkŏk	e ŏ k ŏ k	e ɔ k ɔ k
nanīdŏfŏ	n a n ī d ŏ f ŏ	n a n iː d ɔ f ɔ
èfieĕ	è f ie ĕ	ɛ f i ə
koefadĕ	k oe f a d ĕ	k u f a d ə
èbaka pieĕ	è b a k a + p ie ĕ	ɛ b a k a + p i ə
èofoeè	è o f oe è	ɛ ɔ f u ɛ
bariedāha	b a r ie d ā h a	b a r i d aː h a
abako(k)	a b a k o (k)	a b a k ɔ ʔ
kŏ(k)ŏ(k)	k ŏ (k) ŏ (k)	k ɔ ʔ ɔ ʔ
kadŏkŏ	k a d ŏ k ŏ	k a d ɔ k ɔ
hŏboehā(k)	h ŏ b oe h ā (k)	h ɔ b u h aː ʔ
hŏboha(k)	h ŏ b o h a (k)	h ɔ b ɔ h a ʔ
hiebaka	h ie b a k a	h i b a k a
kamoeninŏ	k a m oe n i n ŏ	k a m u n i n ɔ
māājòk	m āā j ò k	m aː j ɔ k
bahèlè	b a h è l è	b a h ɛ l ɛ
èjakŏ	è j a k ŏ	ɛ j a k ɔ
katjang	k a tj a ng	k a t͡ʃ a ŋ
èhoewè	è h oe w è	ɛ h u w ɛ
kinioenŏ	k i n i oe n ŏ	k i n i u n ɔ
kamakoe	k a m a k oe	k a m a k u
èamaijŏ	è a m a i j ŏ	ɛ a m a i j ɔ
ebae	e b a e	e b a e
kikoha(k)	k i k o h a (k)	k i k ɔ h a ʔ
pokèo	p o k è o	p ɔ k ɛ ɔ
kārādi	k ā r ā d i	k aː r aː d i
oedŏfŏ	oe d ŏ f ŏ	u d ɔ f ɔ
kidjie-kidjie	k i dj ie - k i dj ie	k i d͡ʒ i - k i d͡ʒ i
karahadirĕ èpo(k)	k a r a h a d i r ĕ + è p o (k)	k a r a h a d i r ə + ɛ p ɔ ʔ
èhoewè èpo(k)	è h oe w è + è p o (k)	ɛ h u w ɛ + ɛ p ɔ ʔ
èŏrŏjĕ aero èpo(k)	è ŏ r ŏ j ĕ + a e r o + è p o (k)	ɛ ɔ r ɔ j ə + a e r ɔ + ɛ p ɔ ʔ
èapo(k)	è a p o (k)	ɛ a p ɔ ʔ
èfiak èpo(k)	è f i a k + è p o (k)	ɛ f i a k + ɛ p ɔ ʔ
minoe minoe	m i n oe + m i n oe	m i n u + m i n u
mènŏ	m è n ŏ	m ɛ n ɔ
mènŏ	m è n ŏ	m ɛ n ɔ
goela	g oe l a	g u l a
dadă oeloe	d a d ă + oe l oe	d a d ᾰ + u l u
inima	i n i m a	i n i m a
èŏkiŏ	è ŏ k i ŏ	ɛ ɔ k i ɔ
èhŏboe	è h ŏ b oe	ɛ h ɔ b u
èhŏboe	è h ŏ b oe	ɛ h ɔ b u
èietŏ	è ie t ŏ	ɛ i t ɔ
èkèĕ	è k è ĕ	ɛ k ɛ ə
èkèĕ	è k è ĕ	ɛ k ɛ ə
èŏdoe	è ŏ d oe	ɛ ɔ d u
kanŏwa(k)	k a n ŏ w a (k)	k a n ɔ w a ʔ
kinŏnŏ	k i n ŏ n ŏ	k i n ɔ n ɔ
èfainŏ	è f a i n ŏ	ɛ f a i n ɔ
èhiehie	è h ie h ie	ɛ h i ç i
abèha	a b è h a	a b ɛ h a
kahamoemoe	k a h a m oe m oe	k a h a m u m u
kāràdi ĕ	k ā r à d i + ĕ	k aː r a d i + ə
èpoehĕ	è p oe h ĕ	ɛ p u h ə
èpoehĕ	è p oe h ĕ	ɛ p u h ə
èpoehĕ	è p oe h ĕ	ɛ p u h ə
èko(k)	è k o (k)	ɛ k ɔ ʔ
èafodiĕ	è a f o d i ĕ	ɛ a f ɔ d i ə
èkoena	è k oe n a	ɛ k u n a
eàfŏ kabŏrie	e à f ŏ + k a b ŏ r ie	e a f ɔ + k a b ɔ r i
eàfŏdi ĕ	e à f ŏ d i + ĕ	e a f ɔ d i + ə
èba	è b a	ɛ b a
èfoenoe	è f oe n oe	ɛ f u n u
kihoedŏ	k i h oe d ŏ	k i ç u d ɔ
èoelie	è oe l ie	ɛ u l i
èbo kārăha(k) diĕ	è b o + k ā r ă h a (k) + d i ĕ	ɛ b ɔ + k aː r ᾰ h a ʔ + d i ə
èbèdiĕ	è b è d i ĕ	ɛ b ɛ d i ə
èfīdjoe	è f ī dj oe	ɛ f iː d͡ʒ u
èoefĕ	è oe f ĕ	ɛ u f ə
mŏnŏ èoepĕ	m ŏ n ŏ + è oe p ĕ	m ɔ n ɔ + ɛ u p ə
foeroekoewĕ	f oe r oe k oe w ĕ	f u r u k u w ə
kŏfiefie	k ŏ f ie f ie	k ɔ f i f i
kakĕlèha	k a k ĕ l è h a	k a k ə l ɛ h a
èpfoejĕ	è p f oe j ĕ	ɛ p f u j ə
kafèfo	k a f è f o	k a f ɛ f ɔ
èhoewa	è h oe w a	ɛ h u w a
èoelie hoewĕdiĕ	è oe l ie + h oe w ĕ d i ĕ	ɛ u l i + h u w ə d i ə
èhoewè	è h oe w è	ɛ h u w ɛ
èhèla	è h è l a	ɛ h ɛ l a
èoek	è oe k	ɛ u k
minjak	m i nj a k	m i ɲ a k
ŏwahŏdā	ŏ w a h ŏ d ā	ɔ w a h ɔ d aː
èiefoe akŏmā	è ie f oe + a k ŏ m ā	ɛ i f u + a k ɔ m aː
ijahŏmā	i j a h ŏ m ā	i j a h ɔ m aː
ŏwahŏdā	ŏ w a h ŏ d ā	ɔ w a h ɔ d aː
èiefoe akŏmā	è ie f oe + a k ŏ m ā	ɛ i f u + a k ɔ m aː
ijahŏmā	i j a h ŏ m ā	i j a h ɔ m aː
kahakoewak	k a h a k oe w a k	k a h a k u w a k
kahioe	k a h i oe	k a h i u
kahŏmè	k a h ŏ m è	k a h ɔ m ɛ
kifŏ kifŏ	k i f ŏ + k i f ŏ	k i f ɔ + k i f ɔ
bèo	b è o	b ɛ ɔ
mèo	m è o	m ɛ ɔ
èara bèo	è a r a + b è o	ɛ a r a + b ɛ ɔ
èaidiă	è a i d i ă	ɛ a i d i ᾰ
hŏkai	h ŏ k a i	h ɔ k a i
ija(k)è	i j a (k) è	i j a ʔ ɛ
kauāpŏ	k a u ā p ŏ	k a u aː p ɔ
kanoeoenoe	k a n oe oe n oe	k a n u u n u
kauāpŏ	k a u ā p ŏ	k a u aː p ɔ
kanoeoenoe	k a n oe oe n oe	k a n u u n u
èfa èfa	è f a + è f a	ɛ f a + ɛ f a
poeroeroei	p oe r oe r oe i	p u r u r u i
èoefĕdieĕ	è oe f ĕ d ie ĕ	ɛ u f ə d i ə
èfōdiĕ	è f ō d i ĕ	ɛ f oː d i ə
èara	è a r a	ɛ a r a
èŏbŏ	è ŏ b ŏ	ɛ ɔ b ɔ
èkŏjŏ(k)	è k ŏ j ŏ (k)	ɛ k ɔ j ɔ ʔ
ărŏmaka	ă r ŏ m a k a	ᾰ r ɔ m a k a
kikèŏfa	k i k è ŏ f a	k i k ɛ ɔ f a
kambing	k a m b i ng	k a m b i ŋ
bèo	b è o	b ɛ ɔ
pakoeĕ(k) bèo	p a k oe ĕ (k) + b è o	p a k u ə ʔ + b ɛ ɔ
bèo	b è o	b ɛ ɔ
ejau	e j a u	e j a u
kèèfè	k èè f è	k ɛː f ɛ
èkŏkŏ	è k ŏ k ŏ	ɛ k ɔ k ɔ
kèèfè	k èè f è	k ɛː f ɛ
èoekaikŏ	è oe k a i k ŏ	ɛ u k a i k ɔ
èāhā	è ā h ā	ɛ aː h aː
akōma(k)	a k ō m a (k)	a k oː m a ʔ
poeroehoei	p oe r oe h oe i	p u r u h u i
kèèfa	k èè f a	k ɛː f a
kadĕbĕ(k)	k a d ĕ b ĕ (k)	k a d ə b ə ʔ
èhoenie	è h oe n ie	ɛ h u n i
hoànie	h o à n ie	h ɔ a n i
èhoewā	è h oe w ā	ɛ h u w aː
èpèhĕja	è p è h ĕ j a	ɛ p ɛ h ə j a
kĕwānoe	k ĕ w ā n oe	k ə w aː n u
èhoewā	è h oe w ā	ɛ h u w aː
èpèhĕja	è p è h ĕ j a	ɛ p ɛ h ə j a
kĕwānoe	k ĕ w ā n oe	k ə w aː n u
djalŏ	dj a l ŏ	d͡ʒ a l ɔ
djalŏ	dj a l ŏ	d͡ʒ a l ɔ
djalŏ	dj a l ŏ	d͡ʒ a l ɔ
èhèo	è h è o	ɛ h ɛ ɔ
èkama	è k a m a	ɛ k a m a
èhikoe	è h i k oe	ɛ h i k u
eàboedŏdŏ	e à b oe d ŏ d ŏ	e a b u d ɔ d ɔ
èmiekieĕ	è m ie k ie ĕ	ɛ m i k i ə
èhikoe bèo	è h i k oe + b è o	ɛ h i k u + b ɛ ɔ
poekĕha	p oe k ĕ h a	p u k ə h a
eòemŏ	e ò e m ŏ	e ɔ e m ɔ
kiija	k ii j a	k iː j a
kiija	k ii j a	k iː j a
kiija	k ii j a	k iː j a
èfŏŏfa	è f ŏŏ f a	ɛ f ɔː f a
kŏfènè	k ŏ f è n è	k ɔ f ɛ n ɛ
èkiafŏ	è k i a f ŏ	ɛ k i a f ɔ
èkihŏ	è k i h ŏ	ɛ k i ç ɔ
èkihŏ	è k i h ŏ	ɛ k i ç ɔ
èkihŏ	è k i h ŏ	ɛ k i ç ɔ
èkihŏ	è k i h ŏ	ɛ k i ç ɔ
èanōà	è a n ō à	ɛ a n oː a
èanōà	è a n ō à	ɛ a n oː a
èanōà	è a n ō à	ɛ a n oː a
èhŏdŏ(k)	è h ŏ d ŏ (k)	ɛ h ɔ d ɔ ʔ
paèkā	p a è k ā	p a ɛ k aː
kahaŏdji	k a h a ŏ dj i	k a h a ɔ d͡ʒ i
èkīkè(k)è	è k ī k è (k) è	ɛ k iː k ɛ ʔ ɛ
èkīkè(k)è	è k ī k è (k) è	ɛ k iː k ɛ ʔ ɛ
èkīkè(k)è	è k ī k è (k) è	ɛ k iː k ɛ ʔ ɛ
èfèŏ(k)	è f è ŏ (k)	ɛ f ɛ ɔ ʔ
lahŏfo	l a h ŏ f o	l a h ɔ f ɔ
kahoewe(k)	k a h oe w e (k)	k a h u w e ʔ
lahiejŏ	l a h ie j ŏ	l a h i j ɔ
nafoeĕ	n a f oe ĕ	n a f u ə
èoefoe	è oe f oe	ɛ u f u
kahŏka	k a h ŏ k a	k a h ɔ k a
èoenoe oenoe	è oe n oe + oe n oe	ɛ u n u + u n u
kabieĕ	k a b ie ĕ	k a b i ə
èalahoe	è a l a h oe	ɛ a l a h u
èbaka kahaŏ(k)	è b a k a + k a h a ŏ (k)	ɛ b a k a + k a h a ɔ ʔ
ekanooe	e k a n o oe	e k a n ɔ u
kaho kanoehā(k)	k a h o + k a n oe h ā (k)	k a h ɔ + k a n u h aː ʔ
apoj lŏfŏ	a p o j + l ŏ f ŏ	a p ɔ j + l ɔ f ɔ
eafi-doewa	e a f i - d oe w a	e a f i - d u w a
kamīmī	k a m ī m ī	k a m iː m iː
èlŏpŏ	è l ŏ p ŏ	ɛ l ɔ p ɔ
kalinaha(k)	k a l i n a h a (k)	k a l i n a h a ʔ
èbo	è b o	ɛ b ɔ
poeāri poeāri	p oe ā r i + p oe ā r i	p u aː r i + p u aː r i
kaèlahoe	k a è l a h oe	k a ɛ l a h u
èalahoe	è a l a h oe	ɛ a l a h u
èdoedie	è d oe d ie	ɛ d u d i
èalahoe	è a l a h oe	ɛ a l a h u
pakoeda	p a k oe d a	p a k u d a
èĕkapakoeda	è ĕ k a p a k oe d a	ɛ ə k a p a k u d a
èdih	è d i h	ɛ d i ç
èkijoe	è k i j oe	ɛ k i j u
lakŏha(k)	l a k ŏ h a (k)	l a k ɔ h a ʔ
èkijoe	è k i j oe	ɛ k i j u
lakŏha(k)	l a k ŏ h a (k)	l a k ɔ h a ʔ
èbŏ	è b ŏ	ɛ b ɔ
èoewè	è oe w è	ɛ u w ɛ
kababaha(k)	k a b a b a h a (k)	k a b a b a h a ʔ
aba-ŏkie oewĕ	a b a - ŏ k ie + oe w ĕ	a b a - ɔ k i + u w ə
akŏhŏdă oewè	a k ŏ h ŏ d ă + oe w è	a k ɔ h ɔ d ᾰ + u w ɛ
nanaoewè	n a n a oe w è	n a n a u w ɛ
kahanakiĕ	k a h a n a k i ĕ	k a h a n a k i ə
èhèkoewĕ	è h è k oe w ĕ	ɛ h ɛ k u w ə
ejokie	e j o k ie	e j ɔ k i
ehadieĕ	e h a d ie ĕ	e h a d i ə
èfè	è f è	ɛ f ɛ
ihiā	i h i ā	i ç i aː
panāoewè kèfoe	p a n ā oe w è + k è f oe	p a n aː u w ɛ + k ɛ f u
èbaka oewè	è b a k a + oe w è	ɛ b a k a + u w ɛ
èjahèla	è j a h è l a	ɛ j a h ɛ l a
kōāka oewè	k ō ā k a + oe w è	k oː aː k a + u w ɛ
pakaŏ	p a k a ŏ	p a k a ɔ
èēja	è ē j a	ɛ eː j a
ijokie	i j o k ie	i j ɔ k i
èlŏpŏ	è l ŏ p ŏ	ɛ l ɔ p ɔ
kèfoe	k è f oe	k ɛ f u
koeroe	k oe r oe	k u r u
koeroe	k oe r oe	k u r u
karahāhŏ	k a r a h ā h ŏ	k a r a h aː h ɔ
èkŏhŏ	è k ŏ h ŏ	ɛ k ɔ h ɔ
èkŏhoi	è k ŏ h o i	ɛ k ɔ h ɔ i
èkŏhoi	è k ŏ h o i	ɛ k ɔ h ɔ i
kiedarāk	k ie d a r ā k	k i d a r aː k
ènafa	è n a f a	ɛ n a f a
èŏŏbŏ	è ŏŏ b ŏ	ɛ ɔː b ɔ
èŏkoewĕ	è ŏ k oe w ĕ	ɛ ɔ k u w ə
èŏkoewĕ	è ŏ k oe w ĕ	ɛ ɔ k u w ə
èoboewĕ	è o b oe w ĕ	ɛ ɔ b u w ə
èèkŏwĕ	èè k ŏ w ĕ	ɛː k ɔ w ə
panaŏ	p a n a ŏ	p a n a ɔ
aka fidja	a k a + f i dj a	a k a + f i d͡ʒ a
aka fidja	a k a + f i dj a	a k a + f i d͡ʒ a
aka fidja	a k a + f i dj a	a k a + f i d͡ʒ a
aka fidja	a k a + f i dj a	a k a + f i d͡ʒ a
èbakĕbo	è b a k ĕ b o	ɛ b a k ə b ɔ
èdŏdie	è d ŏ d ie	ɛ d ɔ d i
èèja(k)	èè j a (k)	ɛː j a ʔ
èloffo	è l o ff o	ɛ l ɔ fː ɔ
èoehoe	è oe h oe	ɛ u h u
haoehaoe	h a oe h a oe	h a u h a u
èau	è a u	ɛ a u
pakamaè	p a k a m a è	p a k a m a ɛ
kalèlèak	k a l è l è a k	k a l ɛ l ɛ a k
bidji-bidji kahieabie	b i dj i - b i dj i + k a h ie a b ie	b i d͡ʒ i - b i d͡ʒ i + k a h i a b i
kalèlèha	k a l è l è h a	k a l ɛ l ɛ h a
kalèlèha	k a l è l è h a	k a l ɛ l ɛ h a
doehoekiee	d oe h oe k ie e	d u h u k i e
ebaka oemo	e b a k a + oe m o	e b a k a + u m ɔ
kiaki-fèoeĕ	k i a k i - f è oe ĕ	k i a k i - f ɛ u ə
părīk kaoewĕ	p ă r ī k + k a oe w ĕ	p ᾰ r iː k + k a u w ə
ānāoe	ā n ā oe	aː n aː u
koedŏdok	k oe d ŏ d o k	k u d ɔ d ɔ k
èhaka bapieĕ	è h a k a + b a p ie ĕ	ɛ h a k a + b a p i ə
èkaka kabājĕoi	è k a k a + k a b ā j ĕ o i	ɛ k a k a + k a b aː j ə ɔ i
ijabakoewā	i j a b a k oe w ā	i j a b a k u w aː
kahĕdiak baēdiăk	k a h ĕ d i a k + b a ē d i ă k	k a h ə d i a k + b a eː d i ᾰ k
dŏboekabandiăk	d ŏ b oe k a b a n d i ă k	d ɔ b u k a b a n d i ᾰ k
afikă èodiè ĕ	a f i k ă + è o d i è + ĕ	a f i k ᾰ + ɛ ɔ d i ɛ + ə
kāoewa	k ā oe w a	k aː u w a
kiŏha	k i ŏ h a	k i ɔ h a
oeabaōdie	oe a b a ō d ie	u a b a oː d i
moko èodie	m o k o + è o d ie	m ɔ k ɔ + ɛ ɔ d i
kīhemanĕ	k ī h e m a n ĕ	k iː h e m a n ə
noki èodie	n o k i + è o d ie	n ɔ k i + ɛ ɔ d i
èodihŏkoei	è o d i h ŏ k oe i	ɛ ɔ d i ç ɔ k u i
abaoea ija ŏnijāk	a b a oe a + i j a + ŏ n i j ā k	a b a u a + i j a + ɔ n i j aː k
oeahauboepèĕ	oe a h a u b oe p è ĕ	u a h a u b u p ɛ ə
oeakau băriak	oe a k a u + b ă r i a k	u a k a u + b ᾰ r i a k
fèfèja(k)ĕ	f è f è j a (k) ĕ	f ɛ f ɛ j a ʔ ə
èèhandie	èè h a n d ie	ɛː h a n d i
fahèriè	f a h è r i è	f a h ɛ r i ɛ
koekèdia(k)	k oe k è d i a (k)	k u k ɛ d i a ʔ
koekèdia(k)	k oe k è d i a (k)	k u k ɛ d i a ʔ
katian	k a t i a n	k a t i a n
èoenèkè katian	è oe n è k è + k a t i a n	ɛ u n ɛ k ɛ + k a t i a n
kabakau	k a b a k a u	k a b a k a u
èŏkŏĕ	è ŏ k ŏ ĕ	ɛ ɔ k ɔ ə
èfakoe	è f a k oe	ɛ f a k u
kafal	k a f a l	k a f a l
kapal	k a p a l	k a p a l
prahoe ŏbie obie	p r a h oe + ŏ b ie + o b ie	p r a h u + ɔ b i + ɔ b i
scotjie	s c o tj ie	s k ɔ t͡ʃ i
kanĕhak	k a n ĕ h a k	k a n ə h a k
èoeba	è oe b a	ɛ u b a
èloha	è l o h a	ɛ l ɔ h a
pakoehè	p a k oe h è	p a k u h ɛ
moenènè	m oe n è n è	m u n ɛ n ɛ
paoepă	p a oe p ă	p a u p ᾰ
ijo	i j o	i j ɔ
èŏdjie	è ŏ dj ie	ɛ ɔ d͡ʒ i
èoi	è o i	ɛ ɔ i
abaoi	a b a o i	a b a ɔ i
bakaŏedjie	b a k a ŏ e dj ie	b a k a ɔ e d͡ʒ i
èhaŏdjie	è h a ŏ dj ie	ɛ h a ɔ d͡ʒ i
èfakoe	è f a k oe	ɛ f a k u
èhèkoe	è h è k oe	ɛ h ɛ k u
kikèĕ	k i k è ĕ	k i k ɛ ə
amoehŏ	a m oe h ŏ	a m u h ɔ
adèījĕ	a d è ī j ĕ	a d ɛ iː j ə
kakoeka	k a k oe k a	k a k u k a
nŏkie	n ŏ k ie	n ɔ k i
aījŏnoe(k)oe	a ī j ŏ n oe (k) oe	a iː j ɔ n u ʔ u
dĕbŏdŏ	d ĕ b ŏ d ŏ	d ə b ɔ d ɔ
boe ōdĕ	b oe + ō d ĕ	b u + oː d ə
kanefoe	k a n e f oe	k a n e f u
kakoeĕ	k a k oe ĕ	k a k u ə
keàbabŏdŏ	k e à b a b ŏ d ŏ	k e a b a b ɔ d ɔ
amoehŏ	a m oe h ŏ	a m u h ɔ
kaaanwĕ	k aaa n w ĕ	k aː n w ə
èafa(k)	è a f a (k)	ɛ a f a ʔ
kiĕ	k i ĕ	k i ə
kiĕ	k i ĕ	k i ə
kanànè	k a n à n è	k a n a n ɛ
kima(k)	k i m a (k)	k i m a ʔ
kimak	k i m a k	k i m a k
èo	è o	ɛ ɔ
kahèkanie	k a h è k a n ie	k a h ɛ k a n i
nioekienio(k)	n i oe k ie n i o (k)	n i u k i n i ɔ ʔ
aīĕjanoe(k)	a ī ĕ j a n oe (k)	a iː ə j a n u ʔ
èno(k)	è n o (k)	ɛ n ɔ ʔ
kafèfè	k a f è f è	k a f ɛ f ɛ
kaaukie	k aa u k ie	k aː u k i
janoe(k)	j a n oe (k)	j a n u ʔ
èno(k)	è n o (k)	ɛ n ɔ ʔ
kanèfoe	k a n è f oe	k a n ɛ f u
kakoeōk	k a k oe ō k	k a k u oː k
noekinoe(k)	n oe k i n oe (k)	n u k i n u ʔ
manèko	m a n è k o	m a n ɛ k ɔ
kājŏ	k ā j ŏ	k aː j ɔ
kaèo	k a è o	k a ɛ ɔ
kadarao	k a d a r a o	k a d a r a ɔ
kāhao	k ā h a o	k aː h a ɔ
pākārah	p ā k ā r a h	p aː k aː r a h
pafèè	p a f èè	p a f ɛː
èădŏ	è ă d ŏ	ɛ ᾰ d ɔ
kahaoe(k)	k a h a oe (k)	k a h a u ʔ
èo(k)	è o (k)	ɛ ɔ ʔ
kajojo	k a j o j o	k a j ɔ j ɔ
kalèla	k a l è l a	k a l ɛ l a
kohorijo	k o h o r i j o	k ɔ h ɔ r i j ɔ
kaīdahandĕ	k a ī d a h a n d ĕ	k a iː d a h a n d ə
èèho	èè h o	ɛː h ɔ
kaäfoeā	k aä f oe ā	k a ʔ a f u aː
kaboeĕboeĕ	k a b oe ĕ b oe ĕ	k a b u ə b u ə
kadiŏfè	k a d i ŏ f è	k a d i ɔ f ɛ
aijĕfoho	a i j ĕ f o h o	a i j ə f ɔ h ɔ
kikoeoekă	k i k oe oe k ă	k i k u u k ᾰ
kimoemoehĕ	k i m oe m oe h ĕ	k i m u m u h ə
kikoeoekă	k i k oe oe k ă	k i k u u k ᾰ
kimoemoehĕ	k i m oe m oe h ĕ	k i m u m u h ə
kidīdēhŏ(k)	k i d ī d ē h ŏ (k)	k i d iː d eː h ɔ ʔ
èo(k)o(k)	è o (k) o (k)	ɛ ɔ ʔ ɔ ʔ
kalèlă	k a l è l ă	k a l ɛ l ᾰ
kaäkihi	k aä k i h i	k a ʔ a k i ç i
makiha(k)	m a k i h a (k)	m a k i ç a ʔ
kamoko	k a m o k o	k a m ɔ k ɔ
kidebo	k i d e b o	k i d e b ɔ
kaoewe	k a oe w e	k a u w e
koina	k o i n a	k ɔ i n a
èieboe	è ie b oe	ɛ i b u
kiŏhā	k i ŏ h ā	k i ɔ h aː
kāoewa	k ā oe w a	k aː u w a
kiŏhā	k i ŏ h ā	k i ɔ h aː
karahèlă	k a r a h è l ă	k a r a h ɛ l ᾰ
hokeora(k) ahèlĕ	h o k e o r a (k) + a h è l ĕ	h ɔ k e ɔ r a ʔ + a h ɛ l ə
kifame	k i f a m e	k i f a m e
eò(k)o(k)	e ò (k) o (k)	e ɔ ʔ ɔ ʔ
pamiere	p a m ie r e	p a m i r e
fakaafie	f a k aa f ie	f a k aː f i
koinŏnā	k o i n ŏ n ā	k ɔ i n ɔ n aː
kĕmoja(k)	k ĕ m o j a (k)	k ə m ɔ j a ʔ
kifèora(k)	k i f è o r a (k)	k i f ɛ ɔ r a ʔ
kifienè	k i f ie n è	k i f i n ɛ
èaak	è aa k	ɛ aː k
koeōdĕ	k oe ō d ĕ	k u oː d ə
manŏniejŏ	m a n ŏ n ie j ŏ	m a n ɔ n i j ɔ
pananamie	p a n a n a m ie	p a n a n a m i
kamoenīno	k a m oe n ī n o	k a m u n iː n ɔ
nŏoninĕ	n ŏ o n i n ĕ	n ɔ ɔ n i n ə
pōbōdā	p ō b ō d ā	p oː b oː d aː
fidjaja	f i dj a j a	f i d͡ʒ a j a
koedŏdŏ	k oe d ŏ d ŏ	k u d ɔ d ɔ
kipara èbahoe	k i p a r a + è b a h oe	k i p a r a + ɛ b a h u
kifĕhaja	k i f ĕ h a j a	k i f ə h a j a
kaboehaja	k a b oe h a j a	k a b u h a j a
kifoi	k i f o i	k i f ɔ i
kimonie	k i m o n ie	k i m ɔ n i
kafai	k a f a i	k a f a i
kaarahĕai	k aa r a h ĕ a i	k aː r a h ə a i
kāākikieĕ	k āā k i k ie ĕ	k aː k i k i ə
kaoewè oewè	k a oe w è + oe w è	k a u w ɛ + u w ɛ
kahieābie	k a h ie ā b ie	k a h i aː b i
kaŏrārie	k a ŏ r ā r ie	k a ɔ r aː r i
kaoerejĕ	k a oe r e j ĕ	k a u r e j ə
kaākŏhŏ	k aā k ŏ h ŏ	k aː k ɔ h ɔ
kahièhiè	k a h i è h i è	k a h i ɛ h i ɛ
kaiekŏkŏ(k)	k a ie k ŏ k ŏ (k)	k a i k ɔ k ɔ ʔ
kabŏ èlā	k a b ŏ + è l ā	k a b ɔ + ɛ l aː
ka iekŏkŏ(k)	k a + ie k ŏ k ŏ (k)	k a + i k ɔ k ɔ ʔ
kakidahaiĕ	k a k i d a h a i ĕ	k a k i d a h a i ə
kakīnīfĕ	k a k ī n ī f ĕ	k a k iː n iː f ə
kakīnīfĕ	k a k ī n ī f ĕ	k a k iː n iː f ə
kanoenoefè	k a n oe n oe f è	k a n u n u f ɛ
noenoe(k)	n oe n oe (k)	n u n u ʔ
abĕĕ adi	a b ĕĕ + a d i	a b əː + a d i
oewabālā	oe w a b ā l ā	u w a b aː l aː
wāhāboepè	w ā h ā b oe p è	w aː h aː b u p ɛ
pènjok	p è nj o k	p ɛ ɲ ɔ k
amĕna(k)	a m ĕ n a (k)	a m ə n a ʔ
akida(k)	a k i d a (k)	a k i d a ʔ
oewakaki	oe w a k a k i	u w a k a k i
kidak	k i d a k	k i d a k
oewa āpoe hāja(k)	oe w a + ā p oe + h ā j a (k)	u w a + aː p u + h aː j a ʔ
kaboehaja(k)	k a b oe h a j a (k)	k a b u h a j a ʔ
pōhōja(k)	p ō h ō j a (k)	p oː h oː j a ʔ
kidĕhaoe	k i d ĕ h a oe	k i d ə h a u
oemahaoe	oe m a h a oe	u m a h a u
pakanoea(k)	p a k a n oe a (k)	p a k a n u a ʔ
bakida(k)	b a k i d a (k)	b a k i d a ʔ
kikaaboe	k i k aa b oe	k i k aː b u
adŏ kahapa(k)	a d ŏ + k a h a p a (k)	a d ɔ + k a h a p a ʔ
kiakahārie	k i a k a h ā r ie	k i a k a h aː r i
koinak	k o i n a k	k ɔ i n a k
kajenŏnŏ	k a j e n ŏ n ŏ	k a j e n ɔ n ɔ
ijanŏnŏ	i j a n ŏ n ŏ	i j a n ɔ n ɔ
ahabèlo	a h a b è l o	a h a b ɛ l ɔ
balelo	b a l e l o	b a l e l ɔ
pānāoe	p ā n ā oe	p aː n aː u
bahèdji	b a h è dj i	b a h ɛ d͡ʒ i
pĕkoeaba	p ĕ k oe a b a	p ə k u a b a
waka	w a k a	w a k a
èdjie	è dj ie	ɛ d͡ʒ i
èhèboe	è h è b oe	ɛ h ɛ b u
èhèlo	è h è l o	ɛ h ɛ l ɔ
èhŏra	è h ŏ r a	ɛ h ɔ r a
aharie	a h a r ie	a h a r i
kīfoehaj	k ī f oe h a j	k iː f u h a j
anoaha(k)	a n o a h a (k)	a n ɔ a h a ʔ
kehafariek	k e h a f a r ie k	k e h a f a r i k
kolè amie amie	k o l è + a m ie + a m ie	k ɔ l ɛ + a m i + a m i
kolè poeha	k o l è + p oe h a	k ɔ l ɛ + p u h a
dŏdŏ	d ŏ d ŏ	d ɔ d ɔ
oefā	oe f ā	u f aː
kiŏfaj	k i ŏ f a j	k i ɔ f a j
oefā	oe f ā	u f aː
wakahadŏ	w a k a h a d ŏ	w a k a h a d ɔ
ŏmŏ	ŏ m ŏ	ɔ m ɔ
ŏmŏkie	ŏ m ŏ k ie	ɔ m ɔ k i
kèaba baoeŏ	k è a b a + b a oe ŏ	k ɛ a b a + b a u ɔ
pamŏ	p a m ŏ	p a m ɔ
oepamŏ	oe p a m ŏ	u p a m ɔ
kahapie	k a h a p ie	k a h a p i
mahapie	m a h a p ie	m a h a p i
kidai(k)joe	k i d a i (k) j oe	k i d a i ʔ j u
abaoè	a b a o è	a b a ɔ ɛ
mèhèbahoe(k)	m è h è b a h oe (k)	m ɛ h ɛ b a h u ʔ
èaaniā	è aa n i ā	ɛ aː n i aː
kàhafie	k à h a f ie	k a h a f i
poekai	p oe k a i	p u k a i
koie	k o ie	k ɔ i
kaoe	k a oe	k a u
kiā hoeŏ	k i ā + h oe ŏ	k i aː + h u ɔ
abaanbŏ	a b aa n b ŏ	a b aː n b ɔ
kihèkok	k i h è k o k	k i ç ɛ k ɔ k
kihanĕ	k i h a n ĕ	k i ç a n ə
kahankĕ	k a h a n k ĕ	k a h a n k ə
oea ka baikoā	oe a + k a + b a i k o ā	u a + k a + b a i k ɔ aː
kikĕrā	k i k ĕ r ā	k i k ə r aː
kafikĕ	k a f i k ĕ	k a f i k ə
pèladieĕ	p è l a d ie ĕ	p ɛ l a d i ə
kifĕhbai	k i f ĕ h b a i	k i f ə h b a i
aboehŏ	a b oe h ŏ	a b u h ɔ
hōda hōda	h ō d a + h ō d a	h oː d a + h oː d a
ami(k)ī(k)	a m i (k) ī (k)	a m i ʔ iː ʔ
afamī(k)	a f a m ī (k)	a f a m iː ʔ
pienoekak	p ie n oe k a k	p i n u k a k
fakieoe	f a k ie oe	f a k i u
pakoeoe	p a k oe oe	p a k u u
karohajĕ	k a r o h a j ĕ	k a r ɔ h a j ə
pakè èbŏ	p a k è + è b ŏ	p a k ɛ + ɛ b ɔ
noenoehoei	n oe n oe h oe i	n u n u h u i
paharie	p a h a r ie	p a h a r i
aharie	a h a r ie	a h a r i
aboepèiejok	a b oe p è ie j o k	a b u p ɛ i j ɔ k
pakèho	p a k è h o	p a k ɛ h ɔ
kieakīenènihai	k ie a k ī e n è n i h a i	k i a k iː e n ɛ n i ç a i
fanènèha(k)	f a n è n è h a (k)	f a n ɛ n ɛ h a ʔ
oehaibi	oe h a i b i	u h a i b i
fahabōha(k)	f a h a b ō h a (k)	f a h a b oː h a ʔ
karahoe	k a r a h oe	k a r a h u
kakiho(k)	k a k i h o (k)	k a k i ç ɔ ʔ
mainŏk	m a i n ŏ k	m a i n ɔ k
homainŏk	h o m a i n ŏ k	h ɔ m a i n ɔ k
mŏhŏmŏ(k)	m ŏ h ŏ m ŏ (k)	m ɔ h ɔ m ɔ ʔ
hoăko(k) wa(k)	h o ă k o (k) + w a (k)	h ɔ ᾰ k ɔ ʔ + w a ʔ
kababa	k a b a b a	k a b a b a
èfoeaka	è f oe a k a	ɛ f u a k a
ĕwak	ĕ w a k	ə w a k
oebidji	oe b i dj i	u b i d͡ʒ i
idjī	i dj ī	i d͡ʒ iː
èkiĕĕ	è k i ĕĕ	ɛ k i əː
moeoe	m oe oe	m u u
moho(k) oekie	m o h o (k) + oe k ie	m ɔ h ɔ ʔ + u k i
kifahondie	k i f a h o n d ie	k i f a h ɔ n d i
kaik	k a i k	k a i k
adoewĕ	a d oe w ĕ	a d u w ə
adoewa	a d oe w a	a d u w a
akoloe	a k o l oe	a k ɔ l u
afa	a f a	a f a
aliba	a l i b a	a l i b a
aribĕ	a r i b ĕ	a r i b ə
kakinĕ	k a k i n ĕ	k a k i n ə
aki	a k i	a k i
akinĕ	a k i n ĕ	a k i n ə
ariba adoewĕ	a r i b a + a d oe w ĕ	a r i b a + a d u w ə
afai-īafā	a f a i - ī a f ā	a f a i - iː a f aː
baikaik	b a i k a i k	b a i k a i k
ibaikaik	i b a i k a i k	i b a i k a i k
kifahoek	k i f a h oe k	k i f a h u k
kāāfoeroe	k āā f oe r oe	k aː f u r u
kifahoekjo kaik	k i f a h oe k j o + k a i k	k i f a h u k j ɔ + k a i k
kifahoekjo adoewĕ	k i f a h oe k j o + a d oe w ĕ	k i f a h u k j ɔ + a d u w ə
kifahoekjo akoloe	k i f a h oe k j o + a k o l oe	k i f a h u k j ɔ + a k ɔ l u
kifahoekjo afa	k i f a h oe k j o + a f a	k i f a h u k j ɔ + a f a
kifahoekjo alibĕ	k i f a h oe k j o + a l i b ĕ	k i f a h u k j ɔ + a l i b ə
kifahoekjo akakinĕ	k i f a h oe k j o + a k a k i n ĕ	k i f a h u k j ɔ + a k a k i n ə
kifahoekjo alibĕ adoewĕ	k i f a h oe k j o + a l i b ĕ + a d oe w ĕ	k i f a h u k j ɔ + a l i b ə + a d u w ə
kifahoekjo afai afa	k i f a h oe k j o + a f a i + a f a	k i f a h u k j ɔ + a f a i + a f a
kifahoekjo baikaik	k i f a h oe k j o + b a i k a i k	k i f a h u k j ɔ + b a i k a i k
kaik taka	k a i k + t a k a	k a i k + t a k a
kaik takajo kaik	k a i k + t a k a j o + k a i k	k a i k + t a k a j ɔ + k a i k
kaik takajo alibĕ	k a i k + t a k a j o + a l i b ĕ	k a i k + t a k a j ɔ + a l i b ə
kaik takajo kifahoek	k a i k + t a k a j o + k i f a h oe k	k a i k + t a k a j ɔ + k i f a h u k
adoewĕ taka	a d oe w ĕ + t a k a	a d u w ə + t a k a
adoewĕ takajo kifahoek	a d oe w ĕ + t a k a j o + k i f a h oe k	a d u w ə + t a k a j ɔ + k i f a h u k
akoloe taka	a k o l oe + t a k a	a k ɔ l u + t a k a
alibĕ taka	a l i b ĕ + t a k a	a l i b ə + t a k a
kifahoek taka	k i f a h oe k + t a k a	k i f a h u k + t a k a
kaik koedodoka	k a i k + k oe d o d o k a	k a i k + k u d ɔ d ɔ k a
kidahŏ	k i d a h ŏ	k i d a h ɔ
kahakoudĕ	k a h a k o u d ĕ	k a h a k ɔ u d ə
nŏ(k)afa	n ŏ (k) a f a	n ɔ ʔ a f a
kahanoeĕ	k a h a n oe ĕ	k a h a n u ə
adoewĕ kanoeĕ	a d oe w ĕ + k a n oe ĕ	a d u w ə + k a n u ə
nè(k)è	n è (k) è	n ɛ ʔ ɛ
ija adoewĕ	i j a + a d oe w ĕ	i j a + a d u w ə
akakanoe	a k a k a n oe	a k a k a n u
hokèora(k)	h o k è o r a (k)	h ɔ k ɛ ɔ r a ʔ
afika	a f i k a	a f i k a
mŏkŏ	m ŏ k ŏ	m ɔ k ɔ
kīhīmanĕ	k ī h ī m a n ĕ	k iː h iː m a n ə
kèhèmanĕ	k è h è m a n ĕ	k ɛ h ɛ m a n ə
hiakikĕ	h i a k i k ĕ	h i a k i k ə
ma(k)aki(k)	m a (k) a k i (k)	m a ʔ a k i ʔ
kihimanĕ	k i h i m a n ĕ	k i ç i m a n ə
kidjĕrŏ	k i dj ĕ r ŏ	k i d͡ʒ ə r ɔ
haèloedă(k)	h a è l oe d ă (k)	h a ɛ l u d ᾰ ʔ
fakidja	f a k i dj a	f a k i d͡ʒ a
kèabak	k è a b a k	k ɛ a b a k
èfīkahaj	è f ī k a h a j	ɛ f iː k a h a j
oewā	oe w ā	u w aː
ŏŏ	ŏŏ	ɔː
ĕĕ	ĕĕ	əː
ĕĕ	ĕĕ	əː
ŏŏ	ŏŏ	ɔː
ĕĕ	ĕĕ	əː
ŏŏ	ŏŏ	ɔː
kija	k i j a	k i j a
oewā	oe w ā	u w aː
ikŏ	i k ŏ	i k ɔ
kija	k i j a	k i j a
èai	è a i	ɛ a i
èaiboe	è a i b oe	ɛ a i b u
èaioe	è a i oe	ɛ a i u
èaioe	è a i oe	ɛ a i u
hŏhā	h ŏ h ā	h ɔ h aː
hā	h ā	h aː
èijah	è i j a h	ɛ i j a h
tiŏ	t i ŏ	t i ɔ
èhĕ	è h ĕ	ɛ h ə
itèk	i t è k	i t ɛ k
itèk	i t è k	i t ɛ k
èana	è a n a	ɛ a n a
itèk	i t è k	i t ɛ k
arè(k)	a r è (k)	a r ɛ ʔ
adè(k)	a d è (k)	a d ɛ ʔ
èjà(k)ā	è j à (k) ā	ɛ j a ʔ aː
djidja	dj i dj a	d͡ʒ i d͡ʒ a
maumanĕ	m a u m a n ĕ	m a u m a n ə
namanihŏ	n a m a n i h ŏ	n a m a n i ç ɔ
fanihiōfi	f a n i h i ō f i	f a n i ç i oː f i
kienŏhŏ	k ie n ŏ h ŏ	k i n ɔ h ɔ
haŏ(k)ha	h a ŏ (k) h a	h a ɔ ʔ h a
haŏ(k)ha	h a ŏ (k) h a	h a ɔ ʔ h a
haŏ(k)ha	h a ŏ (k) h a	h a ɔ ʔ h a
haŏ(k)ha	h a ŏ (k) h a	h a ɔ ʔ h a
haŏ(k)ha	h a ŏ (k) h a	h a ɔ ʔ h a
haŏ(k)ha	h a ŏ (k) h a	h a ɔ ʔ h a
haŏ(k)ha	h a ŏ (k) h a	h a ɔ ʔ h a
haŏ(k)ha	h a ŏ (k) h a	h a ɔ ʔ h a
haŏ(k)ha	h a ŏ (k) h a	h a ɔ ʔ h a
haŏ(k)ha	h a ŏ (k) h a	h a ɔ ʔ h a
haŏ(k)ha	h a ŏ (k) h a	h a ɔ ʔ h a
homanika	h o m a n i k a	h ɔ m a n i k a
janieka	j a n ie k a	j a n i k a
eaikaha(k)	e a i k a h a (k)	e a i k a h a ʔ
koahjĕ	k o a h j ĕ	k ɔ a h j ə
kafŏ	k a f ŏ	k a f ɔ
ènoha	è n o h a	ɛ n ɔ h a
dakŏha	d a k ŏ h a	d a k ɔ h a
nŏŏ	n ŏŏ	n ɔː
naafè	n aa f è	n aː f ɛ
nŏŏ	n ŏŏ	n ɔː
kahanoeĕ	k a h a n oe ĕ	k a h a n u ə
pabaka	p a b a k a	p a b a k a
oeakanroe	oe a k a n r oe	u a k a n r u
baoeloe	b a oe l oe	b a u l u
aoeloe	a oe l oe	a u l u
kahanoeĕ	k a h a n oe ĕ	k a h a n u ə
hale	h a l e	h a l e
nèè	n èè	n ɛː
bahaibĕ	b a h a i b ĕ	b a h a i b ə
arapohĕ	a r a p o h ĕ	a r a p ɔ h ə
kaiĕkodiĕ	k a i ĕ k o d i ĕ	k a i ə k ɔ d i ə
nèè	n èè	n ɛː
naoemanĕ	n a oe m a n ĕ	n a u m a n ə
laikahadiĕ	l a i k a h a d i ĕ	l a i k a h a d i ə
mŏkŏkŏ	m ŏ k ŏ k ŏ	m ɔ k ɔ k ɔ
èfāā mahiĕ	è f āā + m a h i ĕ	ɛ f aː + m a h i ə
nakoeānā	n a k oe ā n ā	n a k u aː n aː
nāāfè	n āā f è	n aː f ɛ
aboeha	a b oe h a	a b u h a
māāfè	m āā f è	m aː f ɛ
kaoefè(k)	k a oe f è (k)	k a u f ɛ ʔ
kaoefè(k)	k a oe f è (k)	k a u f ɛ ʔ
kaoefè(k)	k a oe f è (k)	k a u f ɛ ʔ
èèfè	èè f è	ɛː f ɛ
èloeba	è l oe b a	ɛ l u b a
dèbè	d è b è	d ɛ b ɛ
itèbè	i t è b è	i t ɛ b ɛ
koelie tèbè	k oe l ie + t è b è	k u l i + t ɛ b ɛ
itŏfŏ	i t ŏ f ŏ	i t ɔ f ɔ
koeli tŏfŏ	k oe l i + t ŏ f ŏ	k u l i + t ɔ f ɔ
koelie-hŏako(k)	k oe l ie - h ŏ a k o (k)	k u l i - h ɔ a k ɔ ʔ
tŏfŏ	t ŏ f ŏ	t ɔ f ɔ
koelie	k oe l ie	k u l i
ihŏ	i h ŏ	i ç ɔ
pŏkŏ	p ŏ k ŏ	p ɔ k ɔ
kahaĕ	k a h a ĕ	k a h a ə
kokonĕ	k o k o n ĕ	k ɔ k ɔ n ə
fanèna	f a n è n a	f a n ɛ n a
panè	p a n è	p a n ɛ
mil	m i l	m i l
fakè èhèa	f a k è + è h è a	f a k ɛ + ɛ h ɛ a
pakèèhèa	p a k èè h è a	p a k ɛː h ɛ a
mŏkŏ èfōka	m ŏ k ŏ + è f ō k a	m ɔ k ɔ + ɛ f oː k a
ijāha	i j ā h a	i j aː h a
kinŏnŏ	k i n ŏ n ŏ	k i n ɔ n ɔ
èŏdā	è ŏ d ā	ɛ ɔ d aː
nèè	n èè	n ɛː
kienono iĕdiĕ	k ie n o n o + i ĕ d i ĕ	k i n ɔ n ɔ + i ə d i ə
wakipoehaiā	w a k i p oe h a i ā	w a k i p u h a i aː
koina(k) akoina(k)	k o i n a (k) + a k o i n a (k)	k ɔ i n a ʔ + a k ɔ i n a ʔ
oemāhaoe	oe m ā h a oe	u m aː h a u
farakoa	f a r a k o a	f a r a k ɔ a
panako	p a n a k o	p a n a k ɔ
ijo	i j o	i j ɔ
jŏ	j ŏ	j ɔ
kieaba(k)	k ie a b a (k)	k i a b a ʔ
kèo	k è o	k ɛ ɔ
ŏk	ŏ k	ɔ k
èara no(k)a	è a r a + n o (k) a	ɛ a r a + n ɔ ʔ a
ijara(k)	i j a r a (k)	i j a r a ʔ
ŏk	ŏ k	ɔ k
nŏ(k)a	n ŏ (k) a	n ɔ ʔ a
panĕha	p a n ĕ h a	p a n ə h a
kĕabak	k ĕ a b a k	k ə a b a k
kapalå	k a p a l å	k a p a l ɯ
moekå	m oe k å	m u k ɯ
telingå	t e l i ng å	t e l i ŋ ɯ
matå	m a t å	m a t ɯ
dadå	d a d å	d a d ɯ
mengiroek	m e ng i r oe k	m e ŋ i r u k
gĕlå	g ĕ l å	g ə l ɯ
terkoeå	t e r k oe å	t e r k u ɯ
ingè	i ng è	i ŋ ɛ
bakat	b a k a t	b a k a t
boetå	b oe t å	b u t ɯ
ĕbak	ĕ b a k	ə b a k
ĕmak	ĕ m a k	ə m a k
loepå	l oe p å	l u p ɯ
epāpā	e p ā p ā	e p aː p aː
koerīpŏ	k oe r ī p ŏ	k u r iː p ɔ
parorīpŏ	p a r o r ī p ŏ	p a r ɔ r iː p ɔ
èpoekŏ	è p oe k ŏ	ɛ p u k ɔ
piŏ-piŏ	p i ŏ - p i ŏ	p i ɔ - p i ɔ
arŏpāā	a r ŏ p āā	a r ɔ p aː
èpoe(k)oe apŏ	è p oe (k) oe + a p ŏ	ɛ p u ʔ u + a p ɔ
hèoafĕ	h è o a f ĕ	h ɛ ɔ a f ə
poeroeroe	p oe r oe r oe	p u r u r u
wapiaka	w a p i a k a	w a p i a k a
éāpākoe	é ā p ā k oe	ɛ aː p aː k u
kapoehŏ	k a p oe h ŏ	k a p u h ɔ
kipĕrai èdio	k i p ĕ r a i + è d i o	k i p ə r a i + ɛ d i ɔ
kipĕ hŏdŏ	k i p ĕ + h ŏ d ŏ	k i p ə + h ɔ d ɔ
èloppo	è l o pp o	ɛ l ɔ pː ɔ
èhouka	è h o u k a	ɛ h ɔ u k a
pakoewĕ	p a k oe w ĕ	p a k u w ə
èoba	è o b a	ɛ ɔ b a
pakoeroe	p a k oe r oe	p a k u r u
èhaĕ	è h a ĕ	ɛ h a ə
roehoekiĕ(k)	r oe h oe k i ĕ (k)	r u h u k i ə ʔ
pèdjiè	p è dj i è	p ɛ d͡ʒ i ɛ
èoeba	è oe b a	ɛ u b a
kararo	k a r a r o	k a r a r ɔ
karieha	k a r ie h a	k a r i ç a
pabŏrikī	p a b ŏ r i k ī	p a b ɔ r i k iː
èpieĕ	è p ie ĕ	ɛ p i ə
koepadŏ	k oe p a d ŏ	k u p a d ɔ
èŏroe	è ŏ r oe	ɛ ɔ r u
èoedie	è oe d ie	ɛ u d i
èŏroe	è ŏ r oe	ɛ ɔ r u
èpa èpa	è p a + è p a	ɛ p a + ɛ p a
mèo	m è o	m ɛ ɔ
èoepoekŏ	è oe p oe k ŏ	ɛ u p u k ɔ
èpŏŏpa	è p ŏŏ p a	ɛ p ɔː p a
kŏpènè	k ŏ p è n è	k ɔ p ɛ n ɛ
èpèo(k)	è p è o (k)	ɛ p ɛ ɔ ʔ
kokona	k o k o n a	k ɔ k ɔ n a
erihŏ	e r i h ŏ	e r i ç ɔ
èloppo	è l o pp o	ɛ l ɔ pː ɔ
ĕrŏōrai	ĕ r ŏ ō r a i	ə r ɔ oː r a i
èorie	è o r ie	ɛ ɔ r i
moko èarie	m o k o + è a r ie	m ɔ k ɔ + ɛ a r i
pakèlie	p a k è l ie	p a k ɛ l i
aijĕpoho	a i j ĕ p o h o	a i j ə p ɔ h ɔ
kaoewa	k a oe w a	k a u w a
kipamo	k i p a m o	k i p a m ɔ
kipèora(k)	k i p è o r a (k)	k i p ɛ ɔ r a ʔ
pōhōja(k)	p ō h ō j a (k)	p oː h oː j a ʔ
kahapariek	k a h a p a r ie k	k a h a p a r i k
aoedoe	a oe d oe	a u d u
apiha	a p i h a	a p i ç a
naapè	n aa p è	n aː p ɛ
raikaha diĕ	r a i k a h a + d i ĕ	r a i k a h a + d i ə
èèpè	èè p è	ɛː p ɛ
edoeba	e d oe b a	e d u b a
