originals	tokenized	transliterated
kărāhā	k ă r ā h ā	k ă r a a h a a
koedŏdŏkŏ	k oe d ŏ d ŏ k ŏ	k u d O d O k O
èoeloe	è oe l oe	E u l u
èoedoe	è oe d oe	E u d u
èbaka	è b a k a	E b a k a
èkoe(k)	è k oe (k)	E k u '
èaoeloe	è a oe l oe	E a u l u
poeroeroe èoeloe	p oe r oe r oe + è oe l oe	p u r u r u + E u l u
kèlĕkèlĕ poeĕkā	k è l ĕ k è l ĕ + p oe ĕ k ā	k E l ė k E l ė + p u ė k a a
kariehā	k a r ie h ā	k a r i x a a
kaliehĕ	k a l ie h ĕ	k a l i x ė
èbaka	è b a k a	E b a k a
koepènobaka	k oe p è n o b a k a	k u p E n O b a k a
bèbaka	b è b a k a	b E b a k a
èfanoe	è f a n oe	E f a n u
èpanoe	è p a n oe	E p a n u
èfāfā	è f ā f ā	E f a a f a a
èkāā	è k āā	E k a a
koelīfŏ	k oe l ī f ŏ	k u l i i f O
pārŏrīpŏ	p ā r ŏ r ī p ŏ	p a a r O r i i p O
parŏrīpŏ	p a r ŏ r ī p ŏ	p a r O r i i p O
èki(k)	è k i (k)	E k i '
fārŏrīfŏ	f ā r ŏ r ī f ŏ	f a a r O r i i f O
èlieŏ	è l ie ŏ	E l i O
èdieŏ	è d ie ŏ	E d i O
kinoe-oeka	k i n oe - oe k a	k i n u - u k a
nienie	n ie n ie	n i n i
nienie	n ie n ie	n i n i
kĕmoekā(k)	k ĕ m oe k ā (k)	k ė m u k a a '
kīnoeoekă	k ī n oe oe k ă	k i i n u u k ă
ehanoe(k)	e h a n oe (k)	e h a n u '
èokahaĕ	è o k a h a ĕ	E O k a h a ė
èămah	è ă m a h	E ă m a h
èkŏkŏ(k)	è k ŏ k ŏ (k)	E k O k O '
èkŏkŏ(k)	è k ŏ k ŏ (k)	E k O k O '
bèkŏkŏ(k)	b è k ŏ k ŏ (k)	b E k O k O '
bèkŏkŏ(k)	b è k ŏ k ŏ (k)	b E k O k O '
pākŏkŏ(k)	p ā k ŏ k ŏ (k)	p a a k O k O '
kaporiĕ	k a p o r i ĕ	k a p O r i ė
eà oekoe	e à + oe k oe	e a + u k u
bŏbŏ	b ŏ b ŏ	b O b O
èbākoe	è b ā k oe	E b a a k u
fèkoe(k)	f è k oe (k)	f E k u '
pèkoe(k)	p è k oe (k)	p E k u '
èkiedai	è k ie d a i	E k i d a i
kèma	k è m a	k E m a
èfoekĕ	è f oe k ĕ	E f u k ė
èfoekĕ	è f oe k ĕ	E f u k ė
èkahāe	è k a h ā e	E k a h a a e
hahapaoe	h a h a p a oe	h a h a p a u
kèkĕ	k è k ĕ	k E k ė
èhokai	è h o k a i	E h O k a i
èhokai	è h o k a i	E h O k a i
poeri(k)	p oe r i (k)	p u r i '
jo(k)	j o (k)	y O '
amaika	a m a i k a	a m a i k a
apiok	a p i o k	a p i O k
èhaie	è h a ie	E h a i
amaika	a m a i k a	a m a i k a
apiok	a p i o k	a p i O k
èhaie	è h a ie	E h a i
èoekoe(k)	è oe k oe (k)	E u k u '
hèla poewe	h è l a + p oe w e	h E l a + p u w e
hèla poewe	h è l a + p oe w e	h E l a + p u w e
eè	e è	e E
hamaiko	h a m a i k o	h a m a i k O
kamaiko	k a m a i k o	k a m a i k O
wamaiko	w a m a i k o	w a m a i k O
è(i)ko	è ( i ) k o	E ( i ) k O
abakiŏbè	a b a k i ŏ b è	a b a k i O b E
hamaiko	h a m a i k o	h a m a i k O
kamaiko	k a m a i k o	k a m a i k O
wamaiko	w a m a i k o	w a m a i k O
è(i)ko	è ( i ) k o	E ( i ) k O
abakiŏbè	a b a k i ŏ b è	a b a k i O b E
ija(k)è	i j a (k) è	i y a ' E
ija(k)è	i j a (k) è	i y a ' E
hèŏwaj	h è ŏ w a j	h E O w a y
kariha wae	k a r i h a + w a e	k a r i x a + w a e
èijŏ	è i j ŏ	E i y O
èăpara	è ă p a r a	E ă p a r a
èpoe	è p oe	E p u
fiŏ-fiŏ	f i ŏ - f i ŏ	f i O - f i O
pārāhāoedie	p ā r ā h ā oe d ie	p a a r a a h a a u d i
èafŏ	è a f ŏ	E a f O
alŏfāa	a l ŏ f āa	a l O f a a
èfoe(k) oeafĕ	è f oe (k) + oe a f ĕ	E f u ' + u a f ė
hèoafĕ	h è o a f ĕ	h E O a f ė
minoe apŏ	m i n oe + a p ŏ	m i n u + a p O
kau-apŏ	k a u - a p ŏ	k a u - a p O
kaunoeoenoe	k a u n oe oe n oe	k a u n u u n u
naè apo	n a è + a p o	n a E + a p O
naèapo nokie	n a è a p o + n o k ie	n a E a p O + n O k i
èā	è ā	E a a
kijakki	k i j a k k i	k i y a k k i
èhèla	è h è l a	E h E l a
èŏkŏ	è ŏ k ŏ	E O k O
ĕoelie	ĕ oe l ie	ė u l i
foeroeroe	f oe r oe r oe	f u r u r u
èoemo(k)	è oe m o (k)	E u m O '
èitŏfĕ	è i t ŏ f ĕ	E i t O f ė
ahŏpŏ(k)	a h ŏ p ŏ (k)	a h O p O '
amĕnŏ(k)	a m ĕ n ŏ (k)	a m ė n O '
kŏnjŏk	k ŏ nj ŏ k	k O ñ O k
èabanjŏk	è a b a nj ŏ k	E a b a ñ O k
iedjo	ie dj o	i j O
kihoeĕ	k i h oe ĕ	k i x u ė
kŏdŏ(k)	k ŏ d ŏ (k)	k O d O '
oewŏhŏ	oe w ŏ h ŏ	u w O h O
māāniha	m āā n i h a	m a a n i x a
maènoe	m a è n oe	m a E n u
bakŏkoĕ kafoekakō	b a k ŏ k o ĕ + k a f oe k a k ō	b a k O k O ė + k a f u k a k o o
bahèdie	b a h è d ie	b a h E d i
kifoea	k i f oe a	k i f u a
èèkowĕ	èè k o w ĕ	è è k O w ė
bararau	b a r a r a u	b a r a r a u
bakie ŏfŏ	b a k ie + ŏ f ŏ	b a k i + O f O
wakahadŏ	w a k a h a d ŏ	w a k a h a d O
èhekoe	è h e k oe	E h e k u
pakomakja	p a k o m a k j a	p a k O m a k y a
pakowèh	p a k o w è h	p a k O w E h
māākŏ	m āā k ŏ	m a a k O
abaikĕ	a b a i k ĕ	a b a i k ė
kabakīdjŏ	k a b a k ī dj ŏ	k a b a k i i j O
kiparariŏ	k i p a r a r i ŏ	k i p a r a r i O
èdjie	è dj ie	E j i
èfaŏ(k) wa(k)	è f a ŏ (k) + w a (k)	E f a O ' + w a '
abaoekakaj	a b a oe k a k a j	a b a u k a k a y
ĕo(k)oi	ĕ o (k) o i	ė O ' O i
bèlo	b è l o	b E l O
èo(k)oi	è o (k) o i	E O ' O i
kipŏdŏ	k i p ŏ d ŏ	k i p O d O
ahītŏ(k)	a h ī t ŏ (k)	a h i i t O '
èāfākoe	è ā f ā k oe	E a a f a a k u
èèhè	èè h è	è è h E
èfāwāfŏ	è f ā w ā f ŏ	E f a a w a a f O
kaoewa(k)	k a oe w a (k)	k a u w a '
kŏŏda	k ŏŏ d a	k O O d a
hŏpanènèĕ	h ŏ p a n è n è ĕ	h O p a n E n E ė
kaaĕ	k aa ĕ	k a a ė
baaĕ	b aa ĕ	b a a ė
kabakè	k a b a k è	k a b a k E
èamaha	è a m a h a	E a m a h a
patăhālè	p a t ă h ā l è	p a t ă h a a l E
ĕèma	ĕ è m a	ė E m a
èa kanapoeĕ	è a + k a n a p oe ĕ	E a + k a n a p u ė
èa kanapoeĕ	è a + k a n a p oe ĕ	E a + k a n a p u ė
èa kanapoeĕ	è a + k a n a p oe ĕ	E a + k a n a p u ė
kadihoekā	k a d i h oe k ā	k a d i x u k a a
iabahoekā	i a b a h oe k ā	i a b a h u k a a
kīīdōka	k īī d ō k a	k i i d o o k a
èoedafak	è oe d a f a k	E u d a f a k
djako	dj a k o	j a k O
kafoehĕ	k a f oe h ĕ	k a f u h ė
kapoehŏ	k a p oe h ŏ	k a p u h O
kafoehĕ	k a f oe h ĕ	k a f u h ė
kafoehĕ	k a f oe h ĕ	k a f u h ė
kāoewŏ	k ā oe w ŏ	k a a u w O
kĕlèpè	k ĕ l è p è	k ė l E p E
èadoh	è a d o h	E a d O h
kapoehŏ kidai	k a p oe h ŏ + k i d a i	k a p u h O + k i d a i
ĕjoe	ĕ j oe	ė y u
nanaoeni	n a n a oe n i	n a n a u n i
nanaoeni	n a n a oe n i	n a n a u n i
pakoenoejĕ	p a k oe n oe j ĕ	p a k u n u y ė
èoefoe(k)	è oe f oe (k)	E u f u '
piŏnā	p i ŏ n ā	p i O n a a
èla akowĕ	è l a + a k o w ĕ	E l a + a k O w ė
kapoehŏ èoeloe	k a p oe h ŏ + è oe l oe	k a p u h O + E u l u
kapoehŏ èa	k a p oe h ŏ + è a	k a p u h O + E a
ènèĕ	è n è ĕ	E n E ė
ĕkihŏ	ĕ k i h ŏ	ė k i x O
kifafakoe(k)	k i f a f a k oe (k)	k i f a f a k u '
kamakoewa	k a m a k oe w a	k a m a k u w a
kiŏnŏk	k i ŏ n ŏ k	k i O n O k
kehèko(k)ĕ	k e h è k o (k) ĕ	k e h E k O ' ė
kiho(k)ja	k i h o (k) j a	k i x O ' y a
kifarai	k i f a r a i	k i f a r a i
kifalai èbeo	k i f a l a i + è b e o	k i f a l a i + E b e O
kifèhŏdŏ	k i f è h ŏ d ŏ	k i f E h O d O
kakèbara	k a k è b a r a	k a k E b a r a
kakènèbaka	k a k è n è b a k a	k a k E n E b a k a
kipakahariebaka	k i p a k a h a r ie b a k a	k i p a k a h a r i b a k a
kipakahariebaka	k i p a k a h a r ie b a k a	k i p a k a h a r i b a k a
hŏbaoeĕ	h ŏ b a oe ĕ	h O b a u ė
hokŏrŏŏ	h o k ŏ r ŏŏ	h O k O r O O
habèlĕk	h a b è l ĕ k	h a b E l ė k
koahaijĕ	k o a h a i j ĕ	k O a h a i y ė
èhāhā(k)	è h ā h ā (k)	E h a a h a a '
èhāhā(k)	è h ā h ā (k)	E h a a h a a '
èhāhā(k)	è h ā h ā (k)	E h a a h a a '
nioennā tīō	n i oe nn ā + t ī ō	n i u n n a a + t i i o o
kapapo ĕ	k a p a p o + ĕ	k a p a p O + ė
èmanī	è m a n ī	E m a n i i
èhōda	è h ō d a	E h o o d a
èmanī	è m a n ī	E m a n i i
èhōda	è h ō d a	E h o o d a
foinana(k)	f o i n a n a (k)	f O i n a n a '
po(k)inamok	p o (k) i n a m o k	p O ' i n a m O k
ehaw	e h a w	e h a w
pananamie	p a n a n a m ie	p a n a n a m i
nŏwèk	n ŏ w è k	n O w E k
amiemie	a m ie m ie	a m i m i
ama	a m a	a m a
amana	a m a n a	a m a n a
amana	a m a n a	a m a n a
naè	n a è	n a E
naèna	n a è n a	n a E n a
naèna	n a è n a	n a E n a
èara	è a r a	E a r a
èara manie	è a r a + m a n ie	E a r a + m a n i
èara hōda	è a r a + h ō d a	E a r a + h o o d a
oefoenai	oe f oe n a i	u f u n a i
na(k) poenana	n a (k) + p oe n a n a	n a ' + p u n a n a
na(k) poewanahalè	n a (k) + p oe w a n a h a l è	n a ' + p u w a n a h a l E
āāoe(k)	āā oe (k)	a a u '
āāoe(k)	āā oe (k)	a a u '
èāāk	è āā k	E a a k
èhai(k)	è h a i (k)	E h a i '
na afoeaa(k)	n a + a f oe aa (k)	n a + a f u a a '
kahaoewĕ	k a h a oe w ĕ	k a h a u w ė
kahaoewĕ	k a h a oe w ĕ	k a h a u w ė
èlahŏ	è l a h ŏ	E l a h O
èara kahaoewĕ	è a r a + k a h a oe w ĕ	E a r a + k a h a u w ė
èdadoe èara	è d a d oe + è a r a	E d a d u + E a r a
lahiboekĕ èara	l a h i b oe k ĕ + è a r a	l a h i b u k ė + E a r a
oewakipăkoekă	oe w a k i p ă k oe k ă	u w a k i p ă k u k ă
dipăkoekă	d i p ă k oe k ă	d i p ă k u k ă
anŏ(k)	a n ŏ (k)	a n O '
kèābāoewā āno(k)	k è ā b ā oe w ā + ā n o (k)	k E a a b a a u w a a + a a n O '
dadoe(k)	d a d oe (k)	d a d u '
èanŏ(k)	è a n ŏ (k)	E a n O '
lahè boewă(k)	l a h è + b oe w ă (k)	l a h E + b u w ă '
èloffo	è l o ff o	E l O f f O
kaoedara	k a oe d a r a	k a u d a r a
kowèk	k o w è k	k O w E k
hantoe	h a n t oe	h a n t u
èkowèk kaoeè	è k o w è k + k a oe è	E k O w E k + k a u E
hantoe	h a n t oe	h a n t u
èkowèk kiŏha	è k o w è k + k i ŏ h a	E k O w E k + k i O h a
ĕhĕla	ĕ h ĕ l a	ė h ė l a
baridaha	b a r i d a h a	b a r i d a h a
pānānahoe	p ā n ā n a h oe	p a a n a a n a h u
pānānahoe	p ā n ā n a h oe	p a a n a a n a h u
pānānahoe	p ā n ā n a h oe	p a a n a a n a h u
èdjiekanafoeĕ bŏdŏ	è dj ie k a n a f oe ĕ + b ŏ d ŏ	E j i k a n a f u ė + b O d O
èhèboe	è h è b oe	E h E b u
èhèboe	è h è b oe	E h E b u
kodāpākāhā	k o d ā p ā k ā h ā	k O d a a p a a k a a h a a
kèkiĕ abŏdō	k è k i ĕ + a b ŏ d ō	k E k i ė + a b O d o o
kodanŏŏ	k o d a n ŏŏ	k O d a n O O
kaoewa	k a oe w a	k a u w a
kiŏhā	k i ŏ h ā	k i O h a a
hiārā nŏā	h i ā r ā + n ŏ ā	h i a a r a a + n O a a
èahawĕ	è a h a w ĕ	E a h a w ė
èoebatowè	è oe b a t o w è	E u b a t O w E
èjahakaoewĕ	è j a h a k a oe w ĕ	E y a h a k a u w ė
radja	r a dj a	r a j a
mantri	m a n t r i	m a n t r i
èjahakowèk	è j a h a k o w è k	E y a h a k O w E k
kafoe	k a f oe	k a f u
kipara èbahaoe	k i p a r a + è b a h a oe	k i p a r a + E b a h a u
aoena(k) èbahaoe	a oe n a (k) + è b a h a oe	a u n a ' + E b a h a u
pidjaja	p i dj a j a	p i j a y a
kiàkoebai	k i à k oe b a i	k i a k u b a i
kiàkoebai	k i à k oe b a i	k i a k u b a i
èhoukè	è h o u k è	E h O u k E
kidĕhoi	k i d ĕ h o i	k i d ė h O i
paèmŏ	p a è m ŏ	p a E m O
kakau	k a k a u	k a k a u
palahiboewĕ	p a l a h i b oe w ĕ	p a l a h i b u w ė
fakoewĕ	f a k oe w ĕ	f a k u w ė
oekŏ nainĕ	oe k ŏ + n a i n ĕ	u k O + n a i n ė
kiŏmahoe	k i ŏ m a h oe	k i O m a h u
moemahoe	m oe m a h oe	m u m a h u
kŏhaiĕ	k ŏ h a i ĕ	k O h a i ė
paè	p a è	p a E
èhijoe	è h i j oe	E h i y u
pahoemè	p a h oe m è	p a h u m E
kamioe	k a m i oe	k a m i u
èoekoek	è oe k oe k	E u k u k
èobĕ	è o b ĕ	E O b ė
èkŏhŏa(k)	è k ŏ h ŏ a (k)	E k O h O a '
poeroeroedija	p oe r oe r oe d i j a	p u r u r u d i y a
èoekoe	è oe k oe	E u k u
ko(k)èko(k)	k o (k) è k o (k)	k O ' E k O '
anèka	a n è k a	a n E k a
èkèo(k)	è k è o (k)	E k E O '
kinŏnŏ	k i n ŏ n ŏ	k i n O n O
èkarobă	è k a r o b ă	E k a r O b ă
èkarobă	è k a r o b ă	E k a r O b ă
èhèja	è h è j a	E h E y a
èhèja	è h è j a	E h E y a
emenaha	e m e n a h a	e m e n a h a
emenaha	e m e n a h a	e m e n a h a
èoekoe(k)	è oe k oe (k)	E u k u '
piefie	p ie f ie	p i f i
èaahai	è aa h a i	E a a h a i
kobarieè	k o b a r ie è	k O b a r i E
koenă(k)	k oe n ă (k)	k u n ă '
pohanoema	p o h a n oe m a	p O h a n u m a
èoewĕhoă	è oe w ĕ h o ă	E u w ė h O ă
klamboe	k l a m b oe	k l a m b u
èoewĕhoă	è oe w ĕ h o ă	E u w ė h O ă
fahoeroe	f a h oe r oe	f a h u r u
lapĕ(k)	l a p ĕ (k)	l a p ė '
tikar	t i k a r	t i k a r
dadŏ èoeloe	d a d ŏ + è oe l oe	d a d O + E u l u
èhŏkŏ èoeloe	è h ŏ k ŏ + è oe l oe	E h O k O + E u l u
èko ĕma	è k o + ĕ m a	E k O + ė m a
èoko ĕ	è o k o + ĕ	E O k O + ė
ĕpo(k)	ĕ p o (k)	ė p O '
èhaĕ	è h a ĕ	E h a ė
èjobie	è j o b ie	E y O b i
eapoeha	e a p oe h a	e a p u h a
èafauje	è a f a u j e	E a f a u y e
pakoehoeĕ	p a k oe h oe ĕ	p a k u h u ė
kahihŏ	k a h i h ŏ	k a h i x O
kidoeroeka	k i d oe r oe k a	k i d u r u k a
papărie èjobie	p a p ă r ie + è j o b ie	p a p ă r i + E y O b i
kihŏ èjobie	k i h ŏ + è j o b ie	k i x O + E y O b i
poeroe èjobie	p oe r oe + è j o b ie	p u r u + E y O b i
ŏkŏ	ŏ k ŏ	O k O
èīpo(k)	è ī p o (k)	E i i p O '
èkoewĕ	è k oe w ĕ	E k u w ė
doehoekiĕ(k)	d oe h oe k i ĕ (k)	d u h u k i ė '
janieka	j a n ie k a	y a n i k a
poeroe	p oe r oe	p u r u
ekŏnŏnŏhā	e k ŏ n ŏ n ŏ h ā	e k O n O n O h a a
kidjoearŏjĕ	k i dj oe a r ŏ j ĕ	k i j u a r O y ė
klamboe	k l a m b oe	k l a m b u
èhèkoeĕ	è h è k oe ĕ	E h E k u ė
rarieĕ	r a r ie ĕ	r a r i ė
èfoefoe	è f oe f oe	E f u f u
èpoepoe	è p oe p oe	E p u p u
pahoemè	p a h oe m è	p a h u m E
pahoemè	p a h oe m è	p a h u m E
ōnèkĕ	ō n è k ĕ	o o n E k ė
èkainŏ(k)	è k a i n ŏ (k)	E k a i n O '
mangkŏ(k)	m a ng k ŏ (k)	m a n g k O '
tiko	t i k o	t i k O
èau	è a u	E a u
èau	è a u	E a u
èau	è a u	E a u
fèdjie	f è dj ie	f E j i
fèdjie	f è dj ie	f E j i
pakamai	p a k a m a i	p a k a m a i
èkèh	è k è h	E k E h
sendoq	s e n d o q	s e n d O '
sendoq	s e n d o q	s e n d O '
krandjang	k r a n dj a ng	k r a n j a n g
krandjang	k r a n dj a ng	k r a n j a n g
krandjang	k r a n dj a ng	k r a n j a n g
krandjang	k r a n dj a ng	k r a n j a n g
krandjang	k r a n dj a ng	k r a n j a n g
lampoe	l a m p oe	l a m p u
eajaha(k) jobi	e a j a h a (k) + j o b i	e a y a h a ' + y O b i
soemboe	s oe m b oe	s u m b u
mainoe(k)	m a i n oe (k)	m a i n u '
mainoe(k)	m a i n oe (k)	m a i n u '
èoebadiĕ	è oe b a d i ĕ	E u b a d i ė
èoebĕ kain	è oe b ĕ + k a i n	E u b ė + k a i n
foefoe	f oe f oe	f u f u
poeĕda(k)	p oe ĕ d a (k)	p u ė d a '
pahaboehă	p a h a b oe h ă	p a h a b u h ă
gorèng	g o r è ng	g O r E n g
pahèkoe	p a h è k oe	p a h E k u
kè	k è	k E
paboehă	p a b oe h ă	p a b u h ă
koenajŏ	k oe n a j ŏ	k u n a y O
èmèhè(k)	è m è h è (k)	E m E h E '
amĕna(k) mèhè(k)	a m ĕ n a (k) + m è h è (k)	a m ė n a ' + m E h E '
dŏdŏ mèhè(k)	d ŏ d ŏ + m è h è (k)	d O d O + m E h E '
hèla kibaka	h è l a + k i b a k a	h E l a + k i b a k a
hèla	h è l a	h E l a
eàjo	e à j o	e a y O
èara kihŏ	è a r a + k i h ŏ	E a r a + k i x O
èpahjoe	è p a h j oe	E p a h y u
èdakŏ	è d a k ŏ	E d a k O
èēja(k)	è ē j a (k)	E e e y a '
bakèkèk	b a k è k è k	b a k E k E k
pakakak	p a k a k a k	p a k a k a k
kadifakoe	k a d i f a k oe	k a d i f a k u
parihoja(k)	p a r i h o j a (k)	p a r i x O y a '
boeboer	b oe b oe r	b u b u r
kidjie-kidjie	k i dj ie - k i dj ie	k i j i - k i j i
kŏrŏ-kŏrŏ	k ŏ r ŏ - k ŏ r ŏ	k O r O - k O r O
sajoer	s a j oe r	s a y u r
koeŏdŏ	k oe ŏ d ŏ	k u O d O
karāuwā	k a r ā u w ā	k a r a a u w a a
èbājoe	è b ā j oe	E b a a y u
èoefa	è oe f a	E u f a
foeĕhikoe	f oe ĕ h i k oe	f u ė h i k u
kīkī	k ī k ī	k i i k i i
faikiki	f a i k i k i	f a i k i k i
karihā	k a r i h ā	k a r i x a a
ènŏmŏnŏmŏ	è n ŏ m ŏ n ŏ m ŏ	E n O m O n O m O
èmi(k)ie	è m i (k) ie	E m i ' i
èafie	è a f ie	E a f i
kariha oewapŏ	k a r i h a + oe w a p ŏ	k a r i x a + u w a p O
kariehĕ	k a r ie h ĕ	k a r i x ė
kalènang	k a l è n a ng	k a l E n a n g
èaai	è aa i	E a a i
koeŏdŏ	k oe ŏ d ŏ	k u O d O
kainèk	k a i n è k	k a i n E k
kapīdjoe pīdjoe	k a p ī dj oe + p ī dj oe	k a p i i j u + p i i j u
pakoewok	p a k oe w o k	p a k u w O k
paioeka	p a i oe k a	p a i u k a
pakākāriē(k)	p a k ā k ā r i ē (k)	p a k a a k a a r i e e '
èko(k)ia	è k o (k) i a	E k O ' i a
kadīkakālie	k a d ī k a k ā l ie	k a d i i k a k a a l i
èŏkŏ(k)	è ŏ k ŏ (k)	E O k O '
bĕnang	b ĕ n a ng	b ė n a n g
ŏpŏ kabŏkĕ	ŏ p ŏ + k a b ŏ k ĕ	O p O + k a b O k ė
èoba kamakŏ	è o b a + k a m a k ŏ	E O b a + k a m a k O
èhiafo	è h i a f o	E h i a f O
koewabŏ	k oe w a b ŏ	k u w a b O
èkaoijŏ	è k a o i j ŏ	E k a O i y O
èbohè	è b o h è	E b O h E
èpiko(k)	è p i k o (k)	E p i k O '
ŏkia èpiko(k)	ŏ k i a + è p i k o (k)	O k i a + E p i k O '
èara èpiko(k)	è a r a + è p i k o (k)	E a r a + E p i k O '
kīāā	k ī āā	k i i a a
bandèra	b a n d è r a	b a n d E r a
pŏŏkie	p ŏŏ k ie	p O O k i
pŏŏkie	p ŏŏ k ie	p O O k i
pŏŏkie	p ŏŏ k ie	p O O k i
èara fŏŏkie	è a r a + f ŏŏ k ie	E a r a + f O O k i
afŏŏkie	a f ŏŏ k ie	a f O O k i
pabŏrīkī	p a b ŏ r ī k ī	p a b O r i i k i i
fabŏrīkī	f a b ŏ r ī k ī	f a b O r i i k i i
pafoeroe	p a f oe r oe	p a f u r u
wakoeabŏ	w a k oe a b ŏ	w a k u a b O
kapaleàbŏ	k a p a l e à b ŏ	k a p a l e a b O
pŏŏkie	p ŏŏ k ie	p O O k i
kekŏrŏ ĕ	k e k ŏ r ŏ + ĕ	k e k O r O + ė
pakèlie	p a k è l ie	p a k E l i
anĕma	a n ĕ m a	a n ė m a
oewa bakŏhāda	oe w a + b a k ŏ h ā d a	u w a + b a k O h a a d a
hamba soeroeh orang	h a m b a + s oe r oe h + o r a ng	h a m b a + s u r u h + O r a n g
kīdāhăk	k ī d ā h ă k	k i i d a a h ă k
eŏkŏk	e ŏ k ŏ k	e O k O k
nanīdŏfŏ	n a n ī d ŏ f ŏ	n a n i i d O f O
èfieĕ	è f ie ĕ	E f i ė
koefadĕ	k oe f a d ĕ	k u f a d ė
èbaka pieĕ	è b a k a + p ie ĕ	E b a k a + p i ė
èofoeè	è o f oe è	E O f u E
bariedāha	b a r ie d ā h a	b a r i d a a h a
abako(k)	a b a k o (k)	a b a k O '
kŏ(k)ŏ(k)	k ŏ (k) ŏ (k)	k O ' O '
kadŏkŏ	k a d ŏ k ŏ	k a d O k O
hŏboehā(k)	h ŏ b oe h ā (k)	h O b u h a a '
hŏboha(k)	h ŏ b o h a (k)	h O b O h a '
hiebaka	h ie b a k a	h i b a k a
kamoeninŏ	k a m oe n i n ŏ	k a m u n i n O
māājòk	m āā j ò k	m a a y O k
bahèlè	b a h è l è	b a h E l E
èjakŏ	è j a k ŏ	E y a k O
katjang	k a tj a ng	k a c a n g
èhoewè	è h oe w è	E h u w E
kinioenŏ	k i n i oe n ŏ	k i n i u n O
kamakoe	k a m a k oe	k a m a k u
èamaijŏ	è a m a i j ŏ	E a m a i y O
ebae	e b a e	e b a e
kikoha(k)	k i k o h a (k)	k i k O h a '
pokèo	p o k è o	p O k E O
kārādi	k ā r ā d i	k a a r a a d i
oedŏfŏ	oe d ŏ f ŏ	u d O f O
kidjie-kidjie	k i dj ie - k i dj ie	k i j i - k i j i
karahadirĕ èpo(k)	k a r a h a d i r ĕ + è p o (k)	k a r a h a d i r ė + E p O '
èhoewè èpo(k)	è h oe w è + è p o (k)	E h u w E + E p O '
èŏrŏjĕ aero èpo(k)	è ŏ r ŏ j ĕ + a e r o + è p o (k)	E O r O y ė + a e r O + E p O '
èapo(k)	è a p o (k)	E a p O '
èfiak èpo(k)	è f i a k + è p o (k)	E f i a k + E p O '
minoe minoe	m i n oe + m i n oe	m i n u + m i n u
mènŏ	m è n ŏ	m E n O
mènŏ	m è n ŏ	m E n O
goela	g oe l a	g u l a
dadă oeloe	d a d ă + oe l oe	d a d ă + u l u
inima	i n i m a	i n i m a
èŏkiŏ	è ŏ k i ŏ	E O k i O
èhŏboe	è h ŏ b oe	E h O b u
èhŏboe	è h ŏ b oe	E h O b u
èietŏ	è ie t ŏ	E i t O
èkèĕ	è k è ĕ	E k E ė
èkèĕ	è k è ĕ	E k E ė
èŏdoe	è ŏ d oe	E O d u
kanŏwa(k)	k a n ŏ w a (k)	k a n O w a '
kinŏnŏ	k i n ŏ n ŏ	k i n O n O
èfainŏ	è f a i n ŏ	E f a i n O
èhiehie	è h ie h ie	E h i x i
abèha	a b è h a	a b E h a
kahamoemoe	k a h a m oe m oe	k a h a m u m u
kāràdi ĕ	k ā r à d i + ĕ	k a a r a d i + ė
èpoehĕ	è p oe h ĕ	E p u h ė
èpoehĕ	è p oe h ĕ	E p u h ė
èpoehĕ	è p oe h ĕ	E p u h ė
èko(k)	è k o (k)	E k O '
èafodiĕ	è a f o d i ĕ	E a f O d i ė
èkoena	è k oe n a	E k u n a
eàfŏ kabŏrie	e à f ŏ + k a b ŏ r ie	e a f O + k a b O r i
eàfŏdi ĕ	e à f ŏ d i + ĕ	e a f O d i + ė
èba	è b a	E b a
èfoenoe	è f oe n oe	E f u n u
kihoedŏ	k i h oe d ŏ	k i x u d O
èoelie	è oe l ie	E u l i
èbo kārăha(k) diĕ	è b o + k ā r ă h a (k) + d i ĕ	E b O + k a a r ă h a ' + d i ė
èbèdiĕ	è b è d i ĕ	E b E d i ė
èfīdjoe	è f ī dj oe	E f i i j u
èoefĕ	è oe f ĕ	E u f ė
mŏnŏ èoepĕ	m ŏ n ŏ + è oe p ĕ	m O n O + E u p ė
foeroekoewĕ	f oe r oe k oe w ĕ	f u r u k u w ė
kŏfiefie	k ŏ f ie f ie	k O f i f i
kakĕlèha	k a k ĕ l è h a	k a k ė l E h a
èpfoejĕ	è p f oe j ĕ	E p f u y ė
kafèfo	k a f è f o	k a f E f O
èhoewa	è h oe w a	E h u w a
èoelie hoewĕdiĕ	è oe l ie + h oe w ĕ d i ĕ	E u l i + h u w ė d i ė
èhoewè	è h oe w è	E h u w E
èhèla	è h è l a	E h E l a
èoek	è oe k	E u k
minjak	m i nj a k	m i ñ a k
ŏwahŏdā	ŏ w a h ŏ d ā	O w a h O d a a
èiefoe akŏmā	è ie f oe + a k ŏ m ā	E i f u + a k O m a a
ijahŏmā	i j a h ŏ m ā	i y a h O m a a
ŏwahŏdā	ŏ w a h ŏ d ā	O w a h O d a a
èiefoe akŏmā	è ie f oe + a k ŏ m ā	E i f u + a k O m a a
ijahŏmā	i j a h ŏ m ā	i y a h O m a a
kahakoewak	k a h a k oe w a k	k a h a k u w a k
kahioe	k a h i oe	k a h i u
kahŏmè	k a h ŏ m è	k a h O m E
kifŏ kifŏ	k i f ŏ + k i f ŏ	k i f O + k i f O
bèo	b è o	b E O
mèo	m è o	m E O
èara bèo	è a r a + b è o	E a r a + b E O
èaidiă	è a i d i ă	E a i d i ă
hŏkai	h ŏ k a i	h O k a i
ija(k)è	i j a (k) è	i y a ' E
kauāpŏ	k a u ā p ŏ	k a u a a p O
kanoeoenoe	k a n oe oe n oe	k a n u u n u
kauāpŏ	k a u ā p ŏ	k a u a a p O
kanoeoenoe	k a n oe oe n oe	k a n u u n u
èfa èfa	è f a + è f a	E f a + E f a
poeroeroei	p oe r oe r oe i	p u r u r u i
èoefĕdieĕ	è oe f ĕ d ie ĕ	E u f ė d i ė
èfōdiĕ	è f ō d i ĕ	E f o o d i ė
èara	è a r a	E a r a
èŏbŏ	è ŏ b ŏ	E O b O
èkŏjŏ(k)	è k ŏ j ŏ (k)	E k O y O '
ărŏmaka	ă r ŏ m a k a	ă r O m a k a
kikèŏfa	k i k è ŏ f a	k i k E O f a
kambing	k a m b i ng	k a m b i n g
bèo	b è o	b E O
pakoeĕ(k) bèo	p a k oe ĕ (k) + b è o	p a k u ė ' + b E O
bèo	b è o	b E O
ejau	e j a u	e y a u
kèèfè	k èè f è	k è è f E
èkŏkŏ	è k ŏ k ŏ	E k O k O
kèèfè	k èè f è	k è è f E
èoekaikŏ	è oe k a i k ŏ	E u k a i k O
èāhā	è ā h ā	E a a h a a
akōma(k)	a k ō m a (k)	a k o o m a '
poeroehoei	p oe r oe h oe i	p u r u h u i
kèèfa	k èè f a	k è è f a
kadĕbĕ(k)	k a d ĕ b ĕ (k)	k a d ė b ė '
èhoenie	è h oe n ie	E h u n i
hoànie	h o à n ie	h O a n i
èhoewā	è h oe w ā	E h u w a a
èpèhĕja	è p è h ĕ j a	E p E h ė y a
kĕwānoe	k ĕ w ā n oe	k ė w a a n u
èhoewā	è h oe w ā	E h u w a a
èpèhĕja	è p è h ĕ j a	E p E h ė y a
kĕwānoe	k ĕ w ā n oe	k ė w a a n u
djalŏ	dj a l ŏ	j a l O
djalŏ	dj a l ŏ	j a l O
djalŏ	dj a l ŏ	j a l O
èhèo	è h è o	E h E O
èkama	è k a m a	E k a m a
èhikoe	è h i k oe	E h i k u
eàboedŏdŏ	e à b oe d ŏ d ŏ	e a b u d O d O
èmiekieĕ	è m ie k ie ĕ	E m i k i ė
èhikoe bèo	è h i k oe + b è o	E h i k u + b E O
poekĕha	p oe k ĕ h a	p u k ė h a
eòemŏ	e ò e m ŏ	e O e m O
kiija	k ii j a	k i i y a
kiija	k ii j a	k i i y a
kiija	k ii j a	k i i y a
èfŏŏfa	è f ŏŏ f a	E f O O f a
kŏfènè	k ŏ f è n è	k O f E n E
èkiafŏ	è k i a f ŏ	E k i a f O
èkihŏ	è k i h ŏ	E k i x O
èkihŏ	è k i h ŏ	E k i x O
èkihŏ	è k i h ŏ	E k i x O
èkihŏ	è k i h ŏ	E k i x O
èanōà	è a n ō à	E a n o o a
èanōà	è a n ō à	E a n o o a
èanōà	è a n ō à	E a n o o a
èhŏdŏ(k)	è h ŏ d ŏ (k)	E h O d O '
paèkā	p a è k ā	p a E k a a
kahaŏdji	k a h a ŏ dj i	k a h a O j i
èkīkè(k)è	è k ī k è (k) è	E k i i k E ' E
èkīkè(k)è	è k ī k è (k) è	E k i i k E ' E
èkīkè(k)è	è k ī k è (k) è	E k i i k E ' E
èfèŏ(k)	è f è ŏ (k)	E f E O '
lahŏfo	l a h ŏ f o	l a h O f O
kahoewe(k)	k a h oe w e (k)	k a h u w e '
lahiejŏ	l a h ie j ŏ	l a h i y O
nafoeĕ	n a f oe ĕ	n a f u ė
èoefoe	è oe f oe	E u f u
kahŏka	k a h ŏ k a	k a h O k a
èoenoe oenoe	è oe n oe + oe n oe	E u n u + u n u
kabieĕ	k a b ie ĕ	k a b i ė
èalahoe	è a l a h oe	E a l a h u
èbaka kahaŏ(k)	è b a k a + k a h a ŏ (k)	E b a k a + k a h a O '
ekanooe	e k a n o oe	e k a n O u
kaho kanoehā(k)	k a h o + k a n oe h ā (k)	k a h O + k a n u h a a '
apoj lŏfŏ	a p o j + l ŏ f ŏ	a p O y + l O f O
eafi-doewa	e a f i - d oe w a	e a f i - d u w a
kamīmī	k a m ī m ī	k a m i i m i i
èlŏpŏ	è l ŏ p ŏ	E l O p O
kalinaha(k)	k a l i n a h a (k)	k a l i n a h a '
èbo	è b o	E b O
poeāri poeāri	p oe ā r i + p oe ā r i	p u a a r i + p u a a r i
kaèlahoe	k a è l a h oe	k a E l a h u
èalahoe	è a l a h oe	E a l a h u
èdoedie	è d oe d ie	E d u d i
èalahoe	è a l a h oe	E a l a h u
pakoeda	p a k oe d a	p a k u d a
èĕkapakoeda	è ĕ k a p a k oe d a	E ė k a p a k u d a
èdih	è d i h	E d i x
èkijoe	è k i j oe	E k i y u
lakŏha(k)	l a k ŏ h a (k)	l a k O h a '
èkijoe	è k i j oe	E k i y u
lakŏha(k)	l a k ŏ h a (k)	l a k O h a '
èbŏ	è b ŏ	E b O
èoewè	è oe w è	E u w E
kababaha(k)	k a b a b a h a (k)	k a b a b a h a '
aba-ŏkie oewĕ	a b a - ŏ k ie + oe w ĕ	a b a - O k i + u w ė
akŏhŏdă oewè	a k ŏ h ŏ d ă + oe w è	a k O h O d ă + u w E
nanaoewè	n a n a oe w è	n a n a u w E
kahanakiĕ	k a h a n a k i ĕ	k a h a n a k i ė
èhèkoewĕ	è h è k oe w ĕ	E h E k u w ė
ejokie	e j o k ie	e y O k i
ehadieĕ	e h a d ie ĕ	e h a d i ė
èfè	è f è	E f E
ihiā	i h i ā	i x i a a
panāoewè kèfoe	p a n ā oe w è + k è f oe	p a n a a u w E + k E f u
èbaka oewè	è b a k a + oe w è	E b a k a + u w E
èjahèla	è j a h è l a	E y a h E l a
kōāka oewè	k ō ā k a + oe w è	k o o a a k a + u w E
pakaŏ	p a k a ŏ	p a k a O
èēja	è ē j a	E e e y a
ijokie	i j o k ie	i y O k i
èlŏpŏ	è l ŏ p ŏ	E l O p O
kèfoe	k è f oe	k E f u
koeroe	k oe r oe	k u r u
koeroe	k oe r oe	k u r u
karahāhŏ	k a r a h ā h ŏ	k a r a h a a h O
èkŏhŏ	è k ŏ h ŏ	E k O h O
èkŏhoi	è k ŏ h o i	E k O h O i
èkŏhoi	è k ŏ h o i	E k O h O i
kiedarāk	k ie d a r ā k	k i d a r a a k
ènafa	è n a f a	E n a f a
èŏŏbŏ	è ŏŏ b ŏ	E O O b O
èŏkoewĕ	è ŏ k oe w ĕ	E O k u w ė
èŏkoewĕ	è ŏ k oe w ĕ	E O k u w ė
èoboewĕ	è o b oe w ĕ	E O b u w ė
èèkŏwĕ	èè k ŏ w ĕ	è è k O w ė
panaŏ	p a n a ŏ	p a n a O
aka fidja	a k a + f i dj a	a k a + f i j a
aka fidja	a k a + f i dj a	a k a + f i j a
aka fidja	a k a + f i dj a	a k a + f i j a
aka fidja	a k a + f i dj a	a k a + f i j a
èbakĕbo	è b a k ĕ b o	E b a k ė b O
èdŏdie	è d ŏ d ie	E d O d i
èèja(k)	èè j a (k)	è è y a '
èloffo	è l o ff o	E l O f f O
èoehoe	è oe h oe	E u h u
haoehaoe	h a oe h a oe	h a u h a u
èau	è a u	E a u
pakamaè	p a k a m a è	p a k a m a E
kalèlèak	k a l è l è a k	k a l E l E a k
bidji-bidji kahieabie	b i dj i - b i dj i + k a h ie a b ie	b i j i - b i j i + k a h i a b i
kalèlèha	k a l è l è h a	k a l E l E h a
kalèlèha	k a l è l è h a	k a l E l E h a
doehoekiee	d oe h oe k ie e	d u h u k i e
ebaka oemo	e b a k a + oe m o	e b a k a + u m O
kiaki-fèoeĕ	k i a k i - f è oe ĕ	k i a k i - f E u ė
părīk kaoewĕ	p ă r ī k + k a oe w ĕ	p ă r i i k + k a u w ė
ānāoe	ā n ā oe	a a n a a u
koedŏdok	k oe d ŏ d o k	k u d O d O k
èhaka bapieĕ	è h a k a + b a p ie ĕ	E h a k a + b a p i ė
èkaka kabājĕoi	è k a k a + k a b ā j ĕ o i	E k a k a + k a b a a y ė O i
ijabakoewā	i j a b a k oe w ā	i y a b a k u w a a
kahĕdiak baēdiăk	k a h ĕ d i a k + b a ē d i ă k	k a h ė d i a k + b a e e d i ă k
dŏboekabandiăk	d ŏ b oe k a b a n d i ă k	d O b u k a b a n d i ă k
afikă èodiè ĕ	a f i k ă + è o d i è + ĕ	a f i k ă + E O d i E + ė
kāoewa	k ā oe w a	k a a u w a
kiŏha	k i ŏ h a	k i O h a
oeabaōdie	oe a b a ō d ie	u a b a o o d i
moko èodie	m o k o + è o d ie	m O k O + E O d i
kīhemanĕ	k ī h e m a n ĕ	k i i h e m a n ė
noki èodie	n o k i + è o d ie	n O k i + E O d i
èodihŏkoei	è o d i h ŏ k oe i	E O d i x O k u i
abaoea ija ŏnijāk	a b a oe a + i j a + ŏ n i j ā k	a b a u a + i y a + O n i y a a k
oeahauboepèĕ	oe a h a u b oe p è ĕ	u a h a u b u p E ė
oeakau băriak	oe a k a u + b ă r i a k	u a k a u + b ă r i a k
fèfèja(k)ĕ	f è f è j a (k) ĕ	f E f E y a ' ė
èèhandie	èè h a n d ie	è è h a n d i
fahèriè	f a h è r i è	f a h E r i E
koekèdia(k)	k oe k è d i a (k)	k u k E d i a '
koekèdia(k)	k oe k è d i a (k)	k u k E d i a '
katian	k a t i a n	k a t i a n
èoenèkè katian	è oe n è k è + k a t i a n	E u n E k E + k a t i a n
kabakau	k a b a k a u	k a b a k a u
èŏkŏĕ	è ŏ k ŏ ĕ	E O k O ė
èfakoe	è f a k oe	E f a k u
kafal	k a f a l	k a f a l
kapal	k a p a l	k a p a l
prahoe ŏbie obie	p r a h oe + ŏ b ie + o b ie	p r a h u + O b i + O b i
scotjie	s c o tj ie	s k O c i
kanĕhak	k a n ĕ h a k	k a n ė h a k
èoeba	è oe b a	E u b a
èloha	è l o h a	E l O h a
pakoehè	p a k oe h è	p a k u h E
moenènè	m oe n è n è	m u n E n E
paoepă	p a oe p ă	p a u p ă
ijo	i j o	i y O
èŏdjie	è ŏ dj ie	E O j i
èoi	è o i	E O i
abaoi	a b a o i	a b a O i
bakaŏedjie	b a k a ŏ e dj ie	b a k a O e j i
èhaŏdjie	è h a ŏ dj ie	E h a O j i
èfakoe	è f a k oe	E f a k u
èhèkoe	è h è k oe	E h E k u
kikèĕ	k i k è ĕ	k i k E ė
amoehŏ	a m oe h ŏ	a m u h O
adèījĕ	a d è ī j ĕ	a d E i i y ė
kakoeka	k a k oe k a	k a k u k a
nŏkie	n ŏ k ie	n O k i
aījŏnoe(k)oe	a ī j ŏ n oe (k) oe	a i i y O n u ' u
dĕbŏdŏ	d ĕ b ŏ d ŏ	d ė b O d O
boe ōdĕ	b oe + ō d ĕ	b u + o o d ė
kanefoe	k a n e f oe	k a n e f u
kakoeĕ	k a k oe ĕ	k a k u ė
keàbabŏdŏ	k e à b a b ŏ d ŏ	k e a b a b O d O
amoehŏ	a m oe h ŏ	a m u h O
kaaanwĕ	k aaa n w ĕ	k a a a n w ė
èafa(k)	è a f a (k)	E a f a '
kiĕ	k i ĕ	k i ė
kiĕ	k i ĕ	k i ė
kanànè	k a n à n è	k a n a n E
kima(k)	k i m a (k)	k i m a '
kimak	k i m a k	k i m a k
èo	è o	E O
kahèkanie	k a h è k a n ie	k a h E k a n i
nioekienio(k)	n i oe k ie n i o (k)	n i u k i n i O '
aīĕjanoe(k)	a ī ĕ j a n oe (k)	a i i ė y a n u '
èno(k)	è n o (k)	E n O '
kafèfè	k a f è f è	k a f E f E
kaaukie	k aa u k ie	k a a u k i
janoe(k)	j a n oe (k)	y a n u '
èno(k)	è n o (k)	E n O '
kanèfoe	k a n è f oe	k a n E f u
kakoeōk	k a k oe ō k	k a k u o o k
noekinoe(k)	n oe k i n oe (k)	n u k i n u '
manèko	m a n è k o	m a n E k O
kājŏ	k ā j ŏ	k a a y O
kaèo	k a è o	k a E O
kadarao	k a d a r a o	k a d a r a O
kāhao	k ā h a o	k a a h a O
pākārah	p ā k ā r a h	p a a k a a r a h
pafèè	p a f èè	p a f è è
èădŏ	è ă d ŏ	E ă d O
kahaoe(k)	k a h a oe (k)	k a h a u '
èo(k)	è o (k)	E O '
kajojo	k a j o j o	k a y O y O
kalèla	k a l è l a	k a l E l a
kohorijo	k o h o r i j o	k O h O r i y O
kaīdahandĕ	k a ī d a h a n d ĕ	k a i i d a h a n d ė
èèho	èè h o	è è h O
kaäfoeā	k aä f oe ā	k a ' a f u a a
kaboeĕboeĕ	k a b oe ĕ b oe ĕ	k a b u ė b u ė
kadiŏfè	k a d i ŏ f è	k a d i O f E
aijĕfoho	a i j ĕ f o h o	a i y ė f O h O
kikoeoekă	k i k oe oe k ă	k i k u u k ă
kimoemoehĕ	k i m oe m oe h ĕ	k i m u m u h ė
kikoeoekă	k i k oe oe k ă	k i k u u k ă
kimoemoehĕ	k i m oe m oe h ĕ	k i m u m u h ė
kidīdēhŏ(k)	k i d ī d ē h ŏ (k)	k i d i i d e e h O '
èo(k)o(k)	è o (k) o (k)	E O ' O '
kalèlă	k a l è l ă	k a l E l ă
kaäkihi	k aä k i h i	k a ' a k i x i
makiha(k)	m a k i h a (k)	m a k i x a '
kamoko	k a m o k o	k a m O k O
kidebo	k i d e b o	k i d e b O
kaoewe	k a oe w e	k a u w e
koina	k o i n a	k O i n a
èieboe	è ie b oe	E i b u
kiŏhā	k i ŏ h ā	k i O h a a
kāoewa	k ā oe w a	k a a u w a
kiŏhā	k i ŏ h ā	k i O h a a
karahèlă	k a r a h è l ă	k a r a h E l ă
hokeora(k) ahèlĕ	h o k e o r a (k) + a h è l ĕ	h O k e O r a ' + a h E l ė
kifame	k i f a m e	k i f a m e
eò(k)o(k)	e ò (k) o (k)	e O ' O '
pamiere	p a m ie r e	p a m i r e
fakaafie	f a k aa f ie	f a k a a f i
koinŏnā	k o i n ŏ n ā	k O i n O n a a
kĕmoja(k)	k ĕ m o j a (k)	k ė m O y a '
kifèora(k)	k i f è o r a (k)	k i f E O r a '
kifienè	k i f ie n è	k i f i n E
èaak	è aa k	E a a k
koeōdĕ	k oe ō d ĕ	k u o o d ė
manŏniejŏ	m a n ŏ n ie j ŏ	m a n O n i y O
pananamie	p a n a n a m ie	p a n a n a m i
kamoenīno	k a m oe n ī n o	k a m u n i i n O
nŏoninĕ	n ŏ o n i n ĕ	n O O n i n ė
pōbōdā	p ō b ō d ā	p o o b o o d a a
fidjaja	f i dj a j a	f i j a y a
koedŏdŏ	k oe d ŏ d ŏ	k u d O d O
kipara èbahoe	k i p a r a + è b a h oe	k i p a r a + E b a h u
kifĕhaja	k i f ĕ h a j a	k i f ė h a y a
kaboehaja	k a b oe h a j a	k a b u h a y a
kifoi	k i f o i	k i f O i
kimonie	k i m o n ie	k i m O n i
kafai	k a f a i	k a f a i
kaarahĕai	k aa r a h ĕ a i	k a a r a h ė a i
kāākikieĕ	k āā k i k ie ĕ	k a a k i k i ė
kaoewè oewè	k a oe w è + oe w è	k a u w E + u w E
kahieābie	k a h ie ā b ie	k a h i a a b i
kaŏrārie	k a ŏ r ā r ie	k a O r a a r i
kaoerejĕ	k a oe r e j ĕ	k a u r e y ė
kaākŏhŏ	k aā k ŏ h ŏ	k a a k O h O
kahièhiè	k a h i è h i è	k a h i E h i E
kaiekŏkŏ(k)	k a ie k ŏ k ŏ (k)	k a i k O k O '
kabŏ èlā	k a b ŏ + è l ā	k a b O + E l a a
ka iekŏkŏ(k)	k a + ie k ŏ k ŏ (k)	k a + i k O k O '
kakidahaiĕ	k a k i d a h a i ĕ	k a k i d a h a i ė
kakīnīfĕ	k a k ī n ī f ĕ	k a k i i n i i f ė
kakīnīfĕ	k a k ī n ī f ĕ	k a k i i n i i f ė
kanoenoefè	k a n oe n oe f è	k a n u n u f E
noenoe(k)	n oe n oe (k)	n u n u '
abĕĕ adi	a b ĕĕ + a d i	a b ė ė + a d i
oewabālā	oe w a b ā l ā	u w a b a a l a a
wāhāboepè	w ā h ā b oe p è	w a a h a a b u p E
pènjok	p è nj o k	p E ñ O k
amĕna(k)	a m ĕ n a (k)	a m ė n a '
akida(k)	a k i d a (k)	a k i d a '
oewakaki	oe w a k a k i	u w a k a k i
kidak	k i d a k	k i d a k
oewa āpoe hāja(k)	oe w a + ā p oe + h ā j a (k)	u w a + a a p u + h a a y a '
kaboehaja(k)	k a b oe h a j a (k)	k a b u h a y a '
pōhōja(k)	p ō h ō j a (k)	p o o h o o y a '
kidĕhaoe	k i d ĕ h a oe	k i d ė h a u
oemahaoe	oe m a h a oe	u m a h a u
pakanoea(k)	p a k a n oe a (k)	p a k a n u a '
bakida(k)	b a k i d a (k)	b a k i d a '
kikaaboe	k i k aa b oe	k i k a a b u
adŏ kahapa(k)	a d ŏ + k a h a p a (k)	a d O + k a h a p a '
kiakahārie	k i a k a h ā r ie	k i a k a h a a r i
koinak	k o i n a k	k O i n a k
kajenŏnŏ	k a j e n ŏ n ŏ	k a y e n O n O
ijanŏnŏ	i j a n ŏ n ŏ	i y a n O n O
ahabèlo	a h a b è l o	a h a b E l O
balelo	b a l e l o	b a l e l O
pānāoe	p ā n ā oe	p a a n a a u
bahèdji	b a h è dj i	b a h E j i
pĕkoeaba	p ĕ k oe a b a	p ė k u a b a
waka	w a k a	w a k a
èdjie	è dj ie	E j i
èhèboe	è h è b oe	E h E b u
èhèlo	è h è l o	E h E l O
èhŏra	è h ŏ r a	E h O r a
aharie	a h a r ie	a h a r i
kīfoehaj	k ī f oe h a j	k i i f u h a y
anoaha(k)	a n o a h a (k)	a n O a h a '
kehafariek	k e h a f a r ie k	k e h a f a r i k
kolè amie amie	k o l è + a m ie + a m ie	k O l E + a m i + a m i
kolè poeha	k o l è + p oe h a	k O l E + p u h a
dŏdŏ	d ŏ d ŏ	d O d O
oefā	oe f ā	u f a a
kiŏfaj	k i ŏ f a j	k i O f a y
oefā	oe f ā	u f a a
wakahadŏ	w a k a h a d ŏ	w a k a h a d O
ŏmŏ	ŏ m ŏ	O m O
ŏmŏkie	ŏ m ŏ k ie	O m O k i
kèaba baoeŏ	k è a b a + b a oe ŏ	k E a b a + b a u O
pamŏ	p a m ŏ	p a m O
oepamŏ	oe p a m ŏ	u p a m O
kahapie	k a h a p ie	k a h a p i
mahapie	m a h a p ie	m a h a p i
kidai(k)joe	k i d a i (k) j oe	k i d a i ' y u
abaoè	a b a o è	a b a O E
mèhèbahoe(k)	m è h è b a h oe (k)	m E h E b a h u '
èaaniā	è aa n i ā	E a a n i a a
kàhafie	k à h a f ie	k a h a f i
poekai	p oe k a i	p u k a i
koie	k o ie	k O i
kaoe	k a oe	k a u
kiā hoeŏ	k i ā + h oe ŏ	k i a a + h u O
abaanbŏ	a b aa n b ŏ	a b a a n b O
kihèkok	k i h è k o k	k i x E k O k
kihanĕ	k i h a n ĕ	k i x a n ė
kahankĕ	k a h a n k ĕ	k a h a n k ė
oea ka baikoā	oe a + k a + b a i k o ā	u a + k a + b a i k O a a
kikĕrā	k i k ĕ r ā	k i k ė r a a
kafikĕ	k a f i k ĕ	k a f i k ė
pèladieĕ	p è l a d ie ĕ	p E l a d i ė
kifĕhbai	k i f ĕ h b a i	k i f ė h b a i
aboehŏ	a b oe h ŏ	a b u h O
hōda hōda	h ō d a + h ō d a	h o o d a + h o o d a
ami(k)ī(k)	a m i (k) ī (k)	a m i ' i i '
afamī(k)	a f a m ī (k)	a f a m i i '
pienoekak	p ie n oe k a k	p i n u k a k
fakieoe	f a k ie oe	f a k i u
pakoeoe	p a k oe oe	p a k u u
karohajĕ	k a r o h a j ĕ	k a r O h a y ė
pakè èbŏ	p a k è + è b ŏ	p a k E + E b O
noenoehoei	n oe n oe h oe i	n u n u h u i
paharie	p a h a r ie	p a h a r i
aharie	a h a r ie	a h a r i
aboepèiejok	a b oe p è ie j o k	a b u p E i y O k
pakèho	p a k è h o	p a k E h O
kieakīenènihai	k ie a k ī e n è n i h a i	k i a k i i e n E n i x a i
fanènèha(k)	f a n è n è h a (k)	f a n E n E h a '
oehaibi	oe h a i b i	u h a i b i
fahabōha(k)	f a h a b ō h a (k)	f a h a b o o h a '
karahoe	k a r a h oe	k a r a h u
kakiho(k)	k a k i h o (k)	k a k i x O '
mainŏk	m a i n ŏ k	m a i n O k
homainŏk	h o m a i n ŏ k	h O m a i n O k
mŏhŏmŏ(k)	m ŏ h ŏ m ŏ (k)	m O h O m O '
hoăko(k) wa(k)	h o ă k o (k) + w a (k)	h O ă k O ' + w a '
kababa	k a b a b a	k a b a b a
èfoeaka	è f oe a k a	E f u a k a
ĕwak	ĕ w a k	ė w a k
oebidji	oe b i dj i	u b i j i
idjī	i dj ī	i j i i
èkiĕĕ	è k i ĕĕ	E k i ė ė
moeoe	m oe oe	m u u
moho(k) oekie	m o h o (k) + oe k ie	m O h O ' + u k i
kifahondie	k i f a h o n d ie	k i f a h O n d i
kaik	k a i k	k a i k
adoewĕ	a d oe w ĕ	a d u w ė
adoewa	a d oe w a	a d u w a
akoloe	a k o l oe	a k O l u
afa	a f a	a f a
aliba	a l i b a	a l i b a
aribĕ	a r i b ĕ	a r i b ė
kakinĕ	k a k i n ĕ	k a k i n ė
aki	a k i	a k i
akinĕ	a k i n ĕ	a k i n ė
ariba adoewĕ	a r i b a + a d oe w ĕ	a r i b a + a d u w ė
afai-īafā	a f a i - ī a f ā	a f a i - i i a f a a
baikaik	b a i k a i k	b a i k a i k
ibaikaik	i b a i k a i k	i b a i k a i k
kifahoek	k i f a h oe k	k i f a h u k
kāāfoeroe	k āā f oe r oe	k a a f u r u
kifahoekjo kaik	k i f a h oe k j o + k a i k	k i f a h u k y O + k a i k
kifahoekjo adoewĕ	k i f a h oe k j o + a d oe w ĕ	k i f a h u k y O + a d u w ė
kifahoekjo akoloe	k i f a h oe k j o + a k o l oe	k i f a h u k y O + a k O l u
kifahoekjo afa	k i f a h oe k j o + a f a	k i f a h u k y O + a f a
kifahoekjo alibĕ	k i f a h oe k j o + a l i b ĕ	k i f a h u k y O + a l i b ė
kifahoekjo akakinĕ	k i f a h oe k j o + a k a k i n ĕ	k i f a h u k y O + a k a k i n ė
kifahoekjo alibĕ adoewĕ	k i f a h oe k j o + a l i b ĕ + a d oe w ĕ	k i f a h u k y O + a l i b ė + a d u w ė
kifahoekjo afai afa	k i f a h oe k j o + a f a i + a f a	k i f a h u k y O + a f a i + a f a
kifahoekjo baikaik	k i f a h oe k j o + b a i k a i k	k i f a h u k y O + b a i k a i k
kaik taka	k a i k + t a k a	k a i k + t a k a
kaik takajo kaik	k a i k + t a k a j o + k a i k	k a i k + t a k a y O + k a i k
kaik takajo alibĕ	k a i k + t a k a j o + a l i b ĕ	k a i k + t a k a y O + a l i b ė
kaik takajo kifahoek	k a i k + t a k a j o + k i f a h oe k	k a i k + t a k a y O + k i f a h u k
adoewĕ taka	a d oe w ĕ + t a k a	a d u w ė + t a k a
adoewĕ takajo kifahoek	a d oe w ĕ + t a k a j o + k i f a h oe k	a d u w ė + t a k a y O + k i f a h u k
akoloe taka	a k o l oe + t a k a	a k O l u + t a k a
alibĕ taka	a l i b ĕ + t a k a	a l i b ė + t a k a
kifahoek taka	k i f a h oe k + t a k a	k i f a h u k + t a k a
kaik koedodoka	k a i k + k oe d o d o k a	k a i k + k u d O d O k a
kidahŏ	k i d a h ŏ	k i d a h O
kahakoudĕ	k a h a k o u d ĕ	k a h a k O u d ė
nŏ(k)afa	n ŏ (k) a f a	n O ' a f a
kahanoeĕ	k a h a n oe ĕ	k a h a n u ė
adoewĕ kanoeĕ	a d oe w ĕ + k a n oe ĕ	a d u w ė + k a n u ė
nè(k)è	n è (k) è	n E ' E
ija adoewĕ	i j a + a d oe w ĕ	i y a + a d u w ė
akakanoe	a k a k a n oe	a k a k a n u
hokèora(k)	h o k è o r a (k)	h O k E O r a '
afika	a f i k a	a f i k a
mŏkŏ	m ŏ k ŏ	m O k O
kīhīmanĕ	k ī h ī m a n ĕ	k i i h i i m a n ė
kèhèmanĕ	k è h è m a n ĕ	k E h E m a n ė
hiakikĕ	h i a k i k ĕ	h i a k i k ė
ma(k)aki(k)	m a (k) a k i (k)	m a ' a k i '
kihimanĕ	k i h i m a n ĕ	k i x i m a n ė
kidjĕrŏ	k i dj ĕ r ŏ	k i j ė r O
haèloedă(k)	h a è l oe d ă (k)	h a E l u d ă '
fakidja	f a k i dj a	f a k i j a
kèabak	k è a b a k	k E a b a k
èfīkahaj	è f ī k a h a j	E f i i k a h a y
oewā	oe w ā	u w a a
ŏŏ	ŏŏ	O O
ĕĕ	ĕĕ	ė ė
ĕĕ	ĕĕ	ė ė
ŏŏ	ŏŏ	O O
ĕĕ	ĕĕ	ė ė
ŏŏ	ŏŏ	O O
kija	k i j a	k i y a
oewā	oe w ā	u w a a
ikŏ	i k ŏ	i k O
kija	k i j a	k i y a
èai	è a i	E a i
èaiboe	è a i b oe	E a i b u
èaioe	è a i oe	E a i u
èaioe	è a i oe	E a i u
hŏhā	h ŏ h ā	h O h a a
hā	h ā	h a a
èijah	è i j a h	E i y a h
tiŏ	t i ŏ	t i O
èhĕ	è h ĕ	E h ė
itèk	i t è k	i t E k
itèk	i t è k	i t E k
èana	è a n a	E a n a
itèk	i t è k	i t E k
arè(k)	a r è (k)	a r E '
adè(k)	a d è (k)	a d E '
èjà(k)ā	è j à (k) ā	E y a ' a a
djidja	dj i dj a	j i j a
maumanĕ	m a u m a n ĕ	m a u m a n ė
namanihŏ	n a m a n i h ŏ	n a m a n i x O
fanihiōfi	f a n i h i ō f i	f a n i x i o o f i
kienŏhŏ	k ie n ŏ h ŏ	k i n O h O
haŏ(k)ha	h a ŏ (k) h a	h a O ' h a
haŏ(k)ha	h a ŏ (k) h a	h a O ' h a
haŏ(k)ha	h a ŏ (k) h a	h a O ' h a
haŏ(k)ha	h a ŏ (k) h a	h a O ' h a
haŏ(k)ha	h a ŏ (k) h a	h a O ' h a
haŏ(k)ha	h a ŏ (k) h a	h a O ' h a
haŏ(k)ha	h a ŏ (k) h a	h a O ' h a
haŏ(k)ha	h a ŏ (k) h a	h a O ' h a
haŏ(k)ha	h a ŏ (k) h a	h a O ' h a
haŏ(k)ha	h a ŏ (k) h a	h a O ' h a
haŏ(k)ha	h a ŏ (k) h a	h a O ' h a
homanika	h o m a n i k a	h O m a n i k a
janieka	j a n ie k a	y a n i k a
eaikaha(k)	e a i k a h a (k)	e a i k a h a '
koahjĕ	k o a h j ĕ	k O a h y ė
kafŏ	k a f ŏ	k a f O
ènoha	è n o h a	E n O h a
dakŏha	d a k ŏ h a	d a k O h a
nŏŏ	n ŏŏ	n O O
naafè	n aa f è	n a a f E
nŏŏ	n ŏŏ	n O O
kahanoeĕ	k a h a n oe ĕ	k a h a n u ė
pabaka	p a b a k a	p a b a k a
oeakanroe	oe a k a n r oe	u a k a n r u
baoeloe	b a oe l oe	b a u l u
aoeloe	a oe l oe	a u l u
kahanoeĕ	k a h a n oe ĕ	k a h a n u ė
hale	h a l e	h a l e
nèè	n èè	n è è
bahaibĕ	b a h a i b ĕ	b a h a i b ė
arapohĕ	a r a p o h ĕ	a r a p O h ė
kaiĕkodiĕ	k a i ĕ k o d i ĕ	k a i ė k O d i ė
nèè	n èè	n è è
naoemanĕ	n a oe m a n ĕ	n a u m a n ė
laikahadiĕ	l a i k a h a d i ĕ	l a i k a h a d i ė
mŏkŏkŏ	m ŏ k ŏ k ŏ	m O k O k O
èfāā mahiĕ	è f āā + m a h i ĕ	E f a a + m a h i ė
nakoeānā	n a k oe ā n ā	n a k u a a n a a
nāāfè	n āā f è	n a a f E
aboeha	a b oe h a	a b u h a
māāfè	m āā f è	m a a f E
kaoefè(k)	k a oe f è (k)	k a u f E '
kaoefè(k)	k a oe f è (k)	k a u f E '
kaoefè(k)	k a oe f è (k)	k a u f E '
èèfè	èè f è	è è f E
èloeba	è l oe b a	E l u b a
dèbè	d è b è	d E b E
itèbè	i t è b è	i t E b E
koelie tèbè	k oe l ie + t è b è	k u l i + t E b E
itŏfŏ	i t ŏ f ŏ	i t O f O
koeli tŏfŏ	k oe l i + t ŏ f ŏ	k u l i + t O f O
koelie-hŏako(k)	k oe l ie - h ŏ a k o (k)	k u l i - h O a k O '
tŏfŏ	t ŏ f ŏ	t O f O
koelie	k oe l ie	k u l i
ihŏ	i h ŏ	i x O
pŏkŏ	p ŏ k ŏ	p O k O
kahaĕ	k a h a ĕ	k a h a ė
kokonĕ	k o k o n ĕ	k O k O n ė
fanèna	f a n è n a	f a n E n a
panè	p a n è	p a n E
mil	m i l	m i l
fakè èhèa	f a k è + è h è a	f a k E + E h E a
pakèèhèa	p a k èè h è a	p a k è è h E a
mŏkŏ èfōka	m ŏ k ŏ + è f ō k a	m O k O + E f o o k a
ijāha	i j ā h a	i y a a h a
kinŏnŏ	k i n ŏ n ŏ	k i n O n O
èŏdā	è ŏ d ā	E O d a a
nèè	n èè	n è è
kienono iĕdiĕ	k ie n o n o + i ĕ d i ĕ	k i n O n O + i ė d i ė
wakipoehaiā	w a k i p oe h a i ā	w a k i p u h a i a a
koina(k) akoina(k)	k o i n a (k) + a k o i n a (k)	k O i n a ' + a k O i n a '
oemāhaoe	oe m ā h a oe	u m a a h a u
farakoa	f a r a k o a	f a r a k O a
panako	p a n a k o	p a n a k O
ijo	i j o	i y O
jŏ	j ŏ	y O
kieaba(k)	k ie a b a (k)	k i a b a '
kèo	k è o	k E O
ŏk	ŏ k	O k
èara no(k)a	è a r a + n o (k) a	E a r a + n O ' a
ijara(k)	i j a r a (k)	i y a r a '
ŏk	ŏ k	O k
nŏ(k)a	n ŏ (k) a	n O ' a
panĕha	p a n ĕ h a	p a n ė h a
kĕabak	k ĕ a b a k	k ė a b a k
kapalå	k a p a l å	k a p a l a
moekå	m oe k å	m u k a
telingå	t e l i ng å	t e l i n g a
matå	m a t å	m a t a
dadå	d a d å	d a d a
mengiroek	m e ng i r oe k	m e n g i r u k
gĕlå	g ĕ l å	g ė l a
terkoeå	t e r k oe å	t e r k u a
ingè	i ng è	i n g E
bakat	b a k a t	b a k a t
boetå	b oe t å	b u t a
ĕbak	ĕ b a k	ė b a k
ĕmak	ĕ m a k	ė m a k
loepå	l oe p å	l u p a
epāpā	e p ā p ā	e p a a p a a
koerīpŏ	k oe r ī p ŏ	k u r i i p O
parorīpŏ	p a r o r ī p ŏ	p a r O r i i p O
èpoekŏ	è p oe k ŏ	E p u k O
piŏ-piŏ	p i ŏ - p i ŏ	p i O - p i O
arŏpāā	a r ŏ p āā	a r O p a a
èpoe(k)oe apŏ	è p oe (k) oe + a p ŏ	E p u ' u + a p O
hèoafĕ	h è o a f ĕ	h E O a f ė
poeroeroe	p oe r oe r oe	p u r u r u
wapiaka	w a p i a k a	w a p i a k a
éāpākoe	é ā p ā k oe	E a a p a a k u
kapoehŏ	k a p oe h ŏ	k a p u h O
kipĕrai èdio	k i p ĕ r a i + è d i o	k i p ė r a i + E d i O
kipĕ hŏdŏ	k i p ĕ + h ŏ d ŏ	k i p ė + h O d O
èloppo	è l o pp o	E l O p p O
èhouka	è h o u k a	E h O u k a
pakoewĕ	p a k oe w ĕ	p a k u w ė
èoba	è o b a	E O b a
pakoeroe	p a k oe r oe	p a k u r u
èhaĕ	è h a ĕ	E h a ė
roehoekiĕ(k)	r oe h oe k i ĕ (k)	r u h u k i ė '
pèdjiè	p è dj i è	p E j i E
èoeba	è oe b a	E u b a
kararo	k a r a r o	k a r a r O
karieha	k a r ie h a	k a r i x a
pabŏrikī	p a b ŏ r i k ī	p a b O r i k i i
èpieĕ	è p ie ĕ	E p i ė
koepadŏ	k oe p a d ŏ	k u p a d O
èŏroe	è ŏ r oe	E O r u
èoedie	è oe d ie	E u d i
èŏroe	è ŏ r oe	E O r u
èpa èpa	è p a + è p a	E p a + E p a
mèo	m è o	m E O
èoepoekŏ	è oe p oe k ŏ	E u p u k O
èpŏŏpa	è p ŏŏ p a	E p O O p a
kŏpènè	k ŏ p è n è	k O p E n E
èpèo(k)	è p è o (k)	E p E O '
kokona	k o k o n a	k O k O n a
erihŏ	e r i h ŏ	e r i x O
èloppo	è l o pp o	E l O p p O
ĕrŏōrai	ĕ r ŏ ō r a i	ė r O o o r a i
èorie	è o r ie	E O r i
moko èarie	m o k o + è a r ie	m O k O + E a r i
pakèlie	p a k è l ie	p a k E l i
aijĕpoho	a i j ĕ p o h o	a i y ė p O h O
kaoewa	k a oe w a	k a u w a
kipamo	k i p a m o	k i p a m O
kipèora(k)	k i p è o r a (k)	k i p E O r a '
pōhōja(k)	p ō h ō j a (k)	p o o h o o y a '
kahapariek	k a h a p a r ie k	k a h a p a r i k
aoedoe	a oe d oe	a u d u
apiha	a p i h a	a p i x a
naapè	n aa p è	n a a p E
raikaha diĕ	r a i k a h a + d i ĕ	r a i k a h a + d i ė
èèpè	èè p è	è è p E
edoeba	e d oe b a	e d u b a
